#separator:tab
#html:false
晶体液和胶体液进行液体治疗有什么区别？	1.晶体液： ①既能补充血容量，又能补充离子 ②有利于休克后肾衰竭的防治 ③易产生组织水肿 2.胶体液： 对扩容效果好，输入后大部分留在血管内
手术前应该做哪些准备？	患者生命安全的需要； 全面了解健康状况及病情； 评估患者对手术及麻醉的耐受性； 寻找危险因素； 制定麻醉方案
ASA分级？	
局麻药毒性反应的防治	1.预防 ①重视麻醉前准备，对病人进行充分的术前评估 ②控制局麻药剂量和注意操作技术 2.治疗 ①一般处理：出现局麻药中毒的症状和体征后，应立即停止注入局麻药，同时进行有效的气道管理，给予纯氧 ②发生抽搐或惊厥时要注意保护病人，避免发生意外的损伤 ③药物治疗：发生抽搐或惊厥时，静脉用药首选苯二氮卓类药物，也可使用丙泊酚或硫喷妥钠；心率降低可使用阿托品、黄麻碱、肾上腺素
如何进行气道管理/维持气道通畅的方法？	托下颌通气道的使用面罩通气气管内插管气管切开喉罩通气道食管-气管联合导管
局麻药的不良反应	1.中枢神经系统毒性反应 眩晕、口周麻木、耳鸣、视物不清——意识丧失，昏迷——强直阵挛性惊厥 2.心血管系统毒性反应 心动过速和高血压——血压下降，心率缓慢 3.过敏反应 皮肤红斑、荨麻疹、咽喉水肿、支气管痉挛、休克
蛛网膜下腔阻滞的适应证	下腹及盆腔手术：如阑尾切除术 肛门及会阴手术：如肛瘘切除术 下肢手术：如截肢术 分娩镇痛
蛛网膜下腔阻滞的并发症	1.腰麻后头痛（最常见） 2.尿潴留 3.神经并发症 ①脑神经受累 ②假性脑脊膜炎 ③粘连性蛛网膜炎 ④马尾神经综合征  （腰麻后头痛的原因是脑脊液经穿刺孔漏出引起颅内压降低和颅内血管扩张。）
硬膜外阻滞的适应证	主要适应于腹部手术，颈部、上肢及胸部手术也可应用
硬膜外阻滞的并发症	1.穿破硬脊膜 2.穿刺针或导管误入血管 3.导管折断 4.全脊麻 5.脊神经根或脊髓损伤 6.硬膜外血肿
全身麻醉的分类	吸入全身麻醉 静脉全身麻醉 静吸复合全身麻醉
[...]是麻醉维持的三大要素	镇静、镇痛和肌松是麻醉维持的三大要素
全身麻醉的特点（临床表现）	意识消失、全身的痛觉丧失、遗忘、反射抑制和一定程度的肌肉松弛
全身麻醉的并发症	1.反流与误吸 2.呼吸道梗阻 3.通气量不足 4.低氧血症 5.术中知晓 6.恶性高热 7.苏醒延迟 8.低体温
常见的气道管理技术	口咽通气管 鼻咽通气管 面罩通气 气管插管技术
控制性降压对机体的影响	主要是脑缺血和心肌缺血 肾小球滤过率下降 肝损伤 眼内压下降，视力障碍
当脑平均动脉压（MAP）在50-150mmHg内，可维持脑血流（CBF）恒定在[...]ml/（100·min)	当脑平均动脉压（MAP）在50-150mmHg内，可维持脑血流（CBF）恒定在50ml/（100·min)
当脑平均动脉压（MAP）在[...]mmHg内，可维持脑血流（CBF）恒定在50ml/（100·min)	当脑平均动脉压（MAP）在50-150mmHg内，可维持脑血流（CBF）恒定在50ml/（100·min)
当收缩压降至[...]mmHg时，肾小球滤过率将随血压下降而降低	当收缩压降至70mmHg时，肾小球滤过率将随血压下降而降低
当收缩压低于[...]mmHg时可能诱发肝损伤	当收缩压低于60mmHg时可能诱发肝损伤
控制性降压的适应证	（BP：血压； ICP：颅内压）
控制性降压的禁忌症	重要器官实质性病变血管病变严重贫血或低血容量颅内压增高病人，在手术开颅前禁止降压有明显机体、器官、组织氧运输降低，酌情未治疗的青光眼
围手术期导致机体低温的因素（低于36℃）	
围手术期导致机体体温过高的因素	
PACU离室的标准	SpO2:血氧饱和度 循环系统：稳定，心率和血压不超过术前值的+-20%并稳定30分钟以上 Steward苏醒评分 Aldrete 评分标准
ICU的转入标准	各种复杂大手术后的危重病人需行呼吸管理和（或）呼吸支持病人多器官功能障碍综合征病人心肺脑复苏后的病人心功能不全，或有严重心律失常病人严重创伤病人器官移植病人短期强化治疗可恢复的急性病人
ICU的转出标准	
氧交换功能的测量指标	动脉血氧分压(PaO2) 动脉血氧含量(CaO2)脉搏血氧饱和度(SpO2）混合静脉血氧饱和度(SvO2)肺泡气-动脉血氧分压差呼吸气中氧浓度氧摄取率(O2ER)氧合指数(PaO2/FiO2)P50
低氧血症的唯一指标是	动脉血氧分压
什么是氧供？	机体通过循环系统单位时间内向组织提供的氧量，即动脉血单位时间内运送氧的速率
氧供的正常值	520-720ml/(min·m2)
氧耗的正常值	110-180ml/(min·m2)
什么是氧耗	单位时间全身组织消耗氧的总量
氧耗增加的因素	SIRS:全身炎症反应综合征
急性呼吸窘迫综合征的临床表现	1.症状和体征 2.影像学检查 3.实验室检查 4.分期
ARDS的临床表现之症状和体征	1.症状 呼吸频数和呼吸窘迫，缺氧、烦躁、出汗，吸氧无缓解 2.体征 早期：呼吸频率加快，双肺闻及少量细湿罗音 进展：闻及水泡音，管状呼吸音
ARDS的临床表现之影像学表现	1.X线胸片 早期：阴性，轻度间质改变 进展：肺纹理增加、斑片状阴影 后期：实变影，“白肺”，支气管充气征 2.CT 更准确的反应病变肺区域的大小
ARDS的临床表现之实验室检查	1.动脉血气分析： PaO2↓，PaCO2↓，PH先↑后↓ PaO2/FiO2↓（必要条件） 2.肺力学检测： 顺应性↓ 气道阻力↑ 3.肺功能检测： 肺容量、肺活量、FRC均↓ 无效腔↑ 动静脉分流↑ 4.血流动力学监测 PAWP（肺动脉楔压）正常或降低； 若PAWP＞18mmHg，则左心衰竭 5.支气管肺泡灌洗液(BALF) 中性粒细胞↑ 蛋白浓度↑ 肺毛细血管渗漏综合征 6.PiCCO（经胸热稀释法）： 肺毛细血管屏障受损、肺水高于心源性肺水肿
ARDS的临床表现之ARDS的分期	1、第一期 (急性损伤期)：  2、第二期 (相对稳定期)：  3、第三期 (急性呼吸衰竭期)：  4、第四期 (终末期)：
ARDS的诊断标准	(1)发病时间 (2)胸部X线或CT成像 (3)水肿原因                (4)氧合
ARDS的治疗原则	(一)控制原发病与感染的治疗  (二)呼吸支持治疗       (三)液体管理：在保证组织灌注的前提下，限制性的液体管理，维持CO (四)药物治疗  (五)营养代谢支持：尽早给予有力的营养支持 (六)维护重要器官功能，防止MODS
氧治疗的适应证	1、纠正低氧血症：针对病因，提高FiO2 2、阻断因缺氧引起的不良反应： 缺氧代偿： 呼吸做功↑氧耗↑呼吸衰竭   心脏做功↑氧耗↑循环衰竭 3、氧治疗的临床适应证： 呼衰、心衰或心梗、休克  烧伤或感染引起的代谢增加  心搏骤停复苏、CO中毒或术后
氧治疗的并发症	1、急性通气功能障碍：COPD       2、吸收性肺不张：FiO2＜50%，较安全  3、氧中毒：长时间吸入高浓度氧    肺水肿、肺泡充血、肺间质改变  顽固性低氧血症、肺萎陷、顺应性降低   1⃣️多发生在慢性阻塞性肺疾病(COPD)病人，平常即有CO2潴留和高碳酸血症，延髓呼吸中枢已适应了升高的CO2,其呼吸功能主要依靠低PaO2刺激颈动脉体的化学感受器引起反射性兴奋来维持。 2⃣️吸入高浓度氧后可将氮气置换出来，结果使肺泡失去了氮气的支撑。随着氧的吸收，肺泡的直径逐渐变小，结果可发生肺萎陷或肺不张
机械通气治疗的适应证	(一)预防性机械通气  1、有发生呼吸衰竭的高危因素：严重COPD，长时间休克、严重败血症、重大创伤 2、减轻心血管系统的负荷： 减少呼吸功和氧耗，心脏术后、心脏储备下降大手术后 (二)治疗性机械通气  1、呼吸生理标准  2.不同基础疾病情况下机械通气治疗的适应证
机械通气治疗的呼吸生理标准	(1)RR＞35次/分  (2)VT（潮气量）＜3ml/kg，VE（每分通气量）＜3L/min或＞20L/min (3)气体交换指标： 当FiO2>50%时，PaO2<50mmHg (4)最大吸气负压(MIF)＜25cmH2O  (5)PaCO2＞50mmHg，COPD患者除外  (6)生理性无效腔/潮气量(VD/VT)＞60%  (7)P(A-a)O2>50mmHg(FiO2=21%) (8)心排出量＜2L/min，或心指数＜1.2L/(min×m2)
不同基础疾病情况下机械通气治疗的适应证	(1) 慢性阻塞性肺疾病(COPD)：      (2)重度持续性支气管哮喘： (3)急性呼吸窘迫综合征(ARDS)：  (4)头部创伤、神经肌肉疾患引起的呼衰 (5)中枢性呼吸抑制引起的呼衰 (6)心肌梗死或充血性心衰合并呼衰
PEPP（呼气终末正压）的生理影响	1、PEEP对肺功能的影响 2、PEEP对心排出量的影响
PEPP对肺的影响	(1)改善肺顺应性和氧的弥散 (2)增加FRC：PEEP＞10cmH2O 萎陷肺泡复张  (3)对肺顺应性的影响：肺顺应性↑  (4)对氧合功能的影响：肺内分流↓PaO2↑  (5)对无效腔通气的影响：病变肺 改善V/Q
PEPP对心排出量的影响	(1)降低回心血量：胸内压↑  (2)降低右心室排血功能：右室后负荷↑  (3)对左心室功能的影响：室间隔左移，CO↓  (4)降低冠脉血流：胸内压↑压迫心脏、冠脉
PEEP的适应证	(1)急性呼衰：FiO2＞60% PaO2≤60mmHg (2)ARDS  (3)肺水肿患者      (4)建立人工气道者  (5)腹部和胸内手术后患者：减少肺部并发症   PEPP：呼气终末正压（指在呼气相结束时，气道压仍然高于大气压） 1⃣️急性呼吸衰竭病人，常合并有小气道早期关闭、肺不张、肺内分流量增加。PEEP治疗可恢复肺容量，增加FRC,防止肺不张 2⃣️在ARDS病人中，因肺泡萎陷而使肺顺应性曲线向左下移位，即顺应性降低。应用PEEP 后，可使已萎陷的肺泡再膨胀。 3⃣️建立人工气道病人，可以预防功能残气量(FRC)的降低，改善氧合 4⃣️肺水肿病人，应用5 ~可预防小气道早期闭合，有利于氧合和降低呼吸做功
机械通气的撤机指征	1、临床一般情况：        (1)循环功能稳定，组织器官灌注良好 (2)严重感染得到有效控制  (3)严重代谢紊乱得到纠正  (4)无严重的呼吸运动障碍  (5)需机械通气治疗原病因基本恢复 2.呼吸功能测定 3.其他因素 (1)中枢神经系统功能基本恢复  (2)营养状况好       (3)主动活动能力基本恢复
呼吸机撤离方法	1、T形管吸氧法       2、CPAP撤机法       3、SIMV撤机法：常用       4、PSV撤机法       5、无创正压通气(NIPPV)撤机法
单选题： PEEP不应超过    A 20cmH2O  B 25cmH2O  C 30cmH2O  D 35cmH2O  E  40cmH2O A	单选题： PEEP不应超过   A 20cmH2O  B 25cmH2O  C 30cmH2O  D 35cmH2O  E  40cmH2O A      正确答案：                 正确率：100%     解析
单选题： 小潮气量容许性高碳酸血症， 小潮气量是    A 3-5ml/kg  B 4-7ml/kg  C 5-8ml/kg  D 6-9ml/kg  E 7-10ml/kg B	单选题： 小潮气量容许性高碳酸血症， 小潮气量是   A 3-5ml/kg  B 4-7ml/kg  C 5-8ml/kg  D 6-9ml/kg  E 7-10ml/kg B      正确答案：                 正确率：100%     解析
动脉血氧含量正常值为 [...]	动脉血氧含量正常值为 19ml/100ml
体温每升高1℃，氧耗增加 [...]	体温每升高1℃，氧耗增加 10%-15%
麻醉前的营养准备：血浆白蛋白:≥[...]g/L	麻醉前的营养准备：血浆白蛋白:≥30g/L  血浆白蛋白的正常值是35-55g/L
麻醉前的营养准备：Hb:≥[...]g/L	麻醉前的营养准备：Hb:≥80g/L
成人麻醉前禁食易消化固体食物及脂肪量较少的食物至少[...]小时，而肉类及油煎制品等脂肪含 量较高的食物需要禁食至少[...]小时。	成人麻醉前禁食易消化固体食物及脂肪量较少的食物至少6小时，而肉类及油煎制品等脂肪含 量较高的食物需要禁食至少8小时。
择期手术禁食水时间： 禁母乳4h，固体食物或奶粉[...]h	择期手术禁食水时间： 禁母乳4h，固体食物或奶粉6h
择期手术禁食水时间： 禁母乳[...]h，固体食物或奶粉6h	择期手术禁食水时间： 禁母乳4h，固体食物或奶粉6h
择期手术禁水时间： 术前[...]h	择期手术禁水时间： 术前2h
麻醉前用药的目的	（1）镇静 （2）镇痛 （3）抑制呼吸道腺体分泌，预防局麻药的毒性反应。 （4）调整自主神经功能，消除或减弱一些不利的神经反射活动。
妊娠[...]个月期间一般认为是手术治疗的最佳时机	妊娠4-6个月期间一般认为是手术治疗的最佳时机
硬膜外麻醉并发截瘫的首要原因是[...]	硬膜外麻醉并发截瘫的首要原因是硬膜外血肿
面罩通气的适应证	无胃内容物返流误吸风险的短小全麻手术气管插管前进行预充氧去氮紧急情况下辅助或控制呼吸
喉罩通气的禁忌证	饱胃，腹内压过高，有反流误吸高险的患者张口度过小(＜2. 5cm-3. 0cm)的患者咽喉部感染，水肿，活动性出血，血管瘤和组织损伤等病变的患者通气压力需大于25cmH20的气道狭窄和慢性阻塞性肺疾病患者
气管插管的并发症	1)气管内插管所引起的创伤 2)气管导管不畅 3)痰液过多或痰痂 4)气管导管插入过深阻塞一侧支气管 5)麻醉机或呼吸机故障
动脉血氧分压的正常值：[...]mmHg	动脉血氧分压的正常值：80-100mmHg
动脉血氧分压： 轻度低氧：[...]mmHg	动脉血氧分压： 轻度低氧：60-79mmHg
动脉血氧分压： 中度低氧：[...]mmHg	动脉血氧分压： 中度低氧：40-59mmHg
动脉血氧分压： 重度低氧：＜[...]mmHg	动脉血氧分压： 重度低氧：＜40mmHg
人体可耐受的最低PaO2是[...]mmHg	人体可耐受的最低PaO2是60mmHg
正常氧合指数： PaO2/FiO2＞[...]mmHg	正常氧合指数： PaO2/FiO2＞300mmHg
氧摄取率（O2ER）＞[...]说明氧需求增加	氧摄取率（O2ER）＞0.32说明氧需求增加
从[...]中获得的混合静脉血标本最理想	从肺动脉中获得的混合静脉血标本最理想
[...]是反映Hb与O2的亲和力的指标	P50是反映Hb与O2的亲和力的指标
温度升高1℃，氧耗增加[...]%	温度升高1℃，氧耗增加10-15%
什么是控制性降压？	在麻醉和手术期间，有目的地降低病人血压并能控制降压程度和持续时间，称为控制性降压。
什么是苏醒延迟？	全麻结束后90min患者意识仍不恢复
急性呼吸衰竭综合征的鉴别诊断	心源性肺水肿：病史，吸氧缓解非心源性肺水肿：病史，吸氧缓解急性肺栓塞：呼吸困难、胸痛、咯血慢性阻塞性肺疾病并发呼吸衰竭：病史、体征特发性肺间质纤维化：高调湿罗音，限制性通气障碍
年龄大于3个月的婴儿其术前血红蛋白不应低于[...]g/L	年龄大于3个月的婴儿其术前血红蛋白不应低于90g/L
屏气时间在[...]秒以上为正常，如屏气时间短于[...]秒，可认为肺功能显著不全	屏气时间在30秒以上为正常，如屏气时间短于20秒，可认为肺功能显著不全
一般以MVV（最大自主通气量）占预计值的[...]%作为手术安全的指标，低于[...]%为低肺功能，低于[...]%者一般列为手术禁忌证	一般以MVV（最大自主通气量）占预计值的50%~60%作为手术安全的指标，低于50%为低肺功能，低于30%者一般列为手术禁忌证
适用于COPD病人因支气管-肺部感染和呼吸衰竭建立有创人工气道机械通气者撤机时宜采用[...]撤机	适用于COPD病人因支气管-肺部感染和呼吸衰竭建立有创人工气道机械通气者撤机时宜采用无创正压通气（NIPPV）撤机
从机械通气过渡到自主呼吸的较安全方法是[...]撤机法	从机械通气过渡到自主呼吸的较安全方法是SIMV撤机法
长期服用β受体阻滞药的手术患者麻醉前应[...]	长期服用β受体阻滞药的手术患者麻醉前应继续服用  心肌缺血中高危患者术前服用β受体阻滞药合理
服用单胺氧化酶抑制药、三环类抗抑郁药必须于术前[...]周停药	服用单胺氧化酶抑制药、三环类抗抑郁药必须于术前2-3周停药
1个月前有长期服用皮质激素者，术前必须[...]	1个月前有长期服用皮质激素者，术前必须恢复使用  否则术中可能发生急性肾上腺皮质功能不全危象
术前有急性呼吸道感染的患者，一般应在感染得到充分控制[...]后可行择期手术	术前有急性呼吸道感染的患者，一般应在感染得到充分控制一周后可行择期手术
基础代谢率（％）=[...]	基础代谢率（％）=0.75×每分钟脉率数+0.74×脉压-72
对术前有急性呼吸道感染者除非急症，手术应暂停，在感染得到充分控制[...]周后再手术	对术前有急性呼吸道感染者除非急症，手术应暂停，在感染得到充分控制一周后再手术
饱食后急诊手术病人选择全麻时，预防误吸的最好措施是[...]	饱食后急诊手术病人选择全麻时，预防误吸的最好措施是清醒气管插管
不同基础疾病情况下机械通气治疗的适应证之 1.COPD	(1) 慢性阻塞性肺疾病(COPD)：      氧疗后，pH＜7.2、PaO2＜50mmHg、PaCO2＞75mmHg       潮气量＜200ml，呼吸频率＞35次/分，早期肺性脑病改变
不同基础疾病情况下机械通气治疗的适应证之 重度持续性支气管哮喘的表现	(2)重度持续性支气管哮喘：四者其一     ①呼吸抑制，神志模糊       ②呼吸肌疲劳       ③PaO2↓且＜60mmHg、SaO2≤90%  PaCO2＞45mmHg、pH＜7.25       ④一般状态逐渐恶化
不同基础疾病情况下机械通气治疗的适应证之 ARDS	(3)急性呼吸窘迫综合征(ARDS)：       氧疗后(FiO2＞60%)PaO2＜60mmHg       或PaO2≥60mmHg合并呼酸
不同基础疾病情况下机械通气治疗的适应证之 心肌梗死或充血性心衰合并呼衰	(6)心肌梗死或充血性心衰合并呼衰     FiO2＞60%时PaO2＜60mmHg  （FiO2:Fraction of inspiration O2 吸氧分数）
不同基础疾病情况下机械通气治疗的适应证之 中枢性呼吸抑制引起的呼衰	(5)中枢性呼吸抑制引起的呼衰 吸氧改善不理想或RR30-40次/分，咳嗽反射减弱、咳痰无力
全麻时返流与误吸处理	1.反流与误吸 减少胃内容物的滞留，促进胃排空，降低胃内压，提高胃液的PH
全麻时通气量不足的处理	3.通气量不足 辅助或控制呼吸直至呼吸肌力的完全恢复，必要时给予拮抗药
全麻时低氧血症的处理	4.低氧血症 增加吸氧浓度，纠正器械故障、增大通气量等
全麻时术中知晓的处理	5.术中知晓 BIS监测
全麻时恶性高热的处理	6.恶性高热 治疗用丹曲林
治疗休克的基本原则	补充血容量纠正酸碱平衡失调心血管活性药物的应用呼吸管理和氧治疗
治疗休克如何补充血容量？	①Hb>100g/L 不必输血 ②Hb<70g/L 应输入浓缩RBC ③Hb介于70-100g/L 酌情而定 ④失血量过大时，输入血浆及凝血因子
休克的治疗：  纠正酸碱平衡失调	①休克早期，经过容量复苏可以自行纠正 ②pH<7.20,心肌收缩力降低、对拟交感胺类药物敏感性下降，使用药物纠正酸中毒 ③碳酸氢钠=SBE (碱剩余)X体重(kg)X0.25 ④给予半量，观察临床表现，检查血气分析，决定是否继续用药
休克治疗：心血管活性药物的应用	①多巴胺：兴奋多巴胺受体及a、β1受体，抗休克取其强心和扩张内脏血管作用。 ②去甲肾上腺素：强效兴奋a受体效应，纠正感染性休克（过量可能造成肾损害） ③多巴酚丁胺：兴奋β1和a受体，兴奋心肌、增加CO； 充血性心力衰竭、心源性和感染性休克。 增加心肌收缩力，增加心率，轻度扩张外周血管。
休克治疗：呼吸管理和氧治疗	吸氧治疗呼吸道正压机械通气治疗胸部物理治疗呼吸道加温呼吸道湿化
休克分类	低血容量性休克  过敏性休克  感染性休克  心源性休克  神经源性休克
ECMO的适应证	（1）急性呼吸衰竭： 急性感染、误吸、严重损伤、肺移植前的过渡、部分新生儿疾病 （2）心功能衰竭： 重症心肌炎、急性心肌梗死导致心源性休克、急性肺栓塞引起循环衰竭和严重低 氧血症、心脏手术后严重低心排、肺动脉高压、心脏移植的术前等待期间 （3）需要心脏和/或肺移植患者等待供体的过渡手段
ECMO的禁忌症	显著的出血倾向预后很差的疾病，如恶性肿瘤的终末期不可逆的器官功能衰竭（心、肺、肝、肾等）脑死亡的病人无法控制的脓毒血症重度免疫抑制
围术期红细胞输注的策略	开放性输血策略限制性输血策略个体化输血策略的提出与展望
开放性输血策略启动的唯一指征：	Hb＜10g/dl
限制性输血策略：	参与启动输血的某个或某些因素，即输血的“触发点”。 Hb>10g/dl：不需要输血 Hb<6g/dl或7g/dL应考虑输血 Hb在6g/dl或7-10g/dl之间：应根据患者实际病情综合考量。
个体化输血策略的提出与展望	是否需要输血取决于病人当时的Hb水平以及反映机体整体氧供和氧耗的指标。
减少围术期失血的措施	外科技术的提高和改进控制性降压主动脉内球囊阻断术术中体温的维持
手术室温度常维持在[...]℃	手术室温度常维持在22～24℃
体温每降低1℃，失血增加约[...]%	体温每降低1℃，失血增加约16%
女性病人启动输血的Hb或Hct水平应该较男性[...]	女性病人启动输血的Hb或Hct水平应该较男性低
浓缩红细胞： 每U含[...]ml全血中全部RBC，总量110ml～120ml	浓缩红细胞： 每U含200ml全血中全部RBC，总量110ml～120ml
浓缩红细胞： 每U含200ml全血中全部RBC，总量[...]ml	浓缩红细胞： 每U含200ml全血中全部RBC，总量110ml～120ml
少白细胞红细胞的保质期是[...]	少白细胞红细胞的保质期是24h
洗涤红细胞的保质期是[...]	洗涤红细胞的保质期是24h
冷冻红细胞的保质期： 保存[...] 解冻后24h	冷冻红细胞的保质期： 保存10年 解冻后24h
什么是洗涤红细胞？	全血经离心去除血浆和白细胞
什么是冷冻红细胞	去除血浆的红细胞加甘油保护剂
冷冻红细胞的保质期： 保存10年 解冻后[...]	冷冻红细胞的保质期： 保存10年 解冻后24h
什么是去白细胞红细胞	去除了80%以上的白细胞的红细胞
围术期自体输血有哪些方式？	术前自体血储存 急性等容性血液稀释 自体血液回收
在术前[...]周采集自身血液储存，术中或术后输回自身	在术前2-4周采集自身血液储存，术中或术后输回自身
恶性肿瘤手术、高危产科手术自体输血方式是：[...]	恶性肿瘤手术、高危产科手术自体输血方式是：急性等容性血液稀释
心脏、脊柱、  肝移植手术自体输血的方式是：[...]	心脏、脊柱、  肝移植手术自体输血的方式是：自体血液回收
病人体内存在多种抗体或为稀有血型的手术时，选用的自体输血方式是：[...]	病人体内存在多种抗体或为稀有血型的手术时，选用的自体输血方式是：自体血液回收
病人低血红蛋白或有出血高风险手术自体输血可采用[...]	病人低血红蛋白或有出血高风险手术自体输血可采用自体血液回收
心源性休克最常见的病因为[...]	心源性休克最常见的病因为心肌梗死
最常见的神经源性休克的病因是[...]	最常见的神经源性休克的病因是钝性颈椎损伤  由于剧烈疼痛、高位脊髓麻醉或损伤引起血管运动中枢抑制，导致血管阻力降低和血管舒张，致使循环血量相对不足而导致的休克，称为神经源性休克
神经源性休克有关的经典症状： [...]	神经源性休克有关的经典症状： 缓慢性心律失常，低血压，潮红的温暖皮肤  神经源性休克导致交感神经张力丧失，因此由迷走神经驱动而产生无抵抗的副交感神经反应。
通常认为收缩压＜[...]mmHg、脉压＜[...]mmHg是休克存在的证据	通常认为收缩压＜90mmHg、脉压＜20mmHg是休克存在的证据
休克时用药： 对于心排出量低，左室充盈压高，体循环血管阻力正常或低下，特别是合并低血压时宜选[...]	休克时用药： 对于心排出量低，左室充盈压高，体循环血管阻力正常或低下，特别是合并低血压时宜选多巴胺
休克用药： 心排血量低、左室充盈压高、体循环血管阻力和动脉压在正常范围的患者则应选用[...]	休克用药： 心排血量低、左室充盈压高、体循环血管阻力和动脉压在正常范围的患者则应选用多巴酚丁胺  多巴酚丁胺： 增加心肌收缩力  增加心率的作用较多巴胺弱  轻度的外周血管扩张作用
休克用药： 心源性休克不适宜使用洋地黄制剂时，可[...]	休克用药： 心源性休克不适宜使用洋地黄制剂时，可合用多巴胺和多巴酚丁胺
ECMO呼吸支持指征： 氧合功能障碍：PaO2<[...]mmHg	ECMO呼吸支持指征： 氧合功能障碍：PaO2<50mmHg
ECMO呼吸支持指征： 急性肺损伤后，PaO2<[...]mmHg,pH<[...]	ECMO呼吸支持指征： 急性肺损伤后，PaO2<40mmHg,pH<7.3达2小时
ECMO呼吸支持指征 人工呼吸3小时后，PaO2<[...]mmHg	ECMO呼吸支持指征 人工呼吸3小时后，PaO2<55mmHg
ECMO的并发症	（1）最常见为出血 （2）插管远端肢体缺血坏死 （3）脑缺血 （4）感染 （5）肾功能不全 （6）血栓形成
单选题： 下列哪项不是休克治疗 的基本原则    A  补充血容量  B  纠正酸碱平衡失调  C  心血管活性药物应用  D  控制性降压 E  呼吸管理和氧治疗 D	单选题： 下列哪项不是休克治疗 的基本原则   A  补充血容量  B  纠正酸碱平衡失调  C  心血管活性药物应用  D  控制性降压 E  呼吸管理和氧治疗 D      正确答案：                 正确率：100%     解析
单选题： 下列哪项不是限制性输血策略的“触发点”    A Hb＞10g/dl不需要输血 B 输血唯一指征Hb＜10g/dl   C Hb＜6g/dl应输血  D 启动输血Hb水平女较男低 E Hb介于7-10g/dl综合考量 B	单选题： 下列哪项不是限制性输血策略的“触发点”   A Hb＞10g/dl不需要输血 B 输血唯一指征Hb＜10g/dl   C Hb＜6g/dl应输血  D 启动输血Hb水平女较男低 E Hb介于7-10g/dl综合考量 B      正确答案：                 正确率：100%     解析
单选题： 下列哪项是ECMO的适应证    A 显著的出血倾向  B 恶性肿瘤终末期  C 心脏移植的术前等待 D 脑死亡病人  E 重度免疫抑制 C	单选题： 下列哪项是ECMO的适应证   A 显著的出血倾向  B 恶性肿瘤终末期  C 心脏移植的术前等待 D 脑死亡病人  E 重度免疫抑制 C      正确答案：                 正确率：100%     解析
动脉置管时临床常用动脉穿刺部位	肱动脉 桡动脉 股动脉 足背动脉
动脉血压监测的临床意义	(1)肺动脉压(PAP)：反映右室后负荷的重要指标。 (2)肺动脉楔压(PAWP)：正常值5-12mmHg,超过20mmHg表示左心室功能欠佳 (3)估计瓣膜病变 (4)绘制左心室功能曲线图
肺动脉收缩压的正常值： PASP：[...]mmHg	肺动脉收缩压的正常值： PASP：15-28mmHg
肺动脉舒张压的正常值： PADP：[...]mmHg	肺动脉舒张压的正常值： PADP：8-15mmHg
不同动脉段记录血压不同：      主动脉→外周小动脉：               收缩压[...]，舒张压[...]，脉压[...]	不同动脉段记录血压不同：      主动脉→外周小动脉：               收缩压升高，舒张压降低，脉压增加
什么是中心静脉压？	指位于胸腔内的上、下腔静脉近右心房入口处的压力，主要反映右心室前负荷。
避免长期静脉营养药物或化疗药物与手臂静脉的直接接触，用于中期或长期的静脉治疗（5天-1年）的置管方式是[...]	避免长期静脉营养药物或化疗药物与手臂静脉的直接接触，用于中期或长期的静脉治疗（5天-1年）的置管方式是经外周静脉穿刺中心静脉置管（PICC）
中心静脉压测定的禁忌症	凝血机制严重障碍者和血气胸病人--行颈内静脉及锁骨下静脉穿刺需谨慎 局部皮肤感染者--更换穿刺部位
CVP正常值[...]cmH2O	CVP正常值5～12cmH2O
CVP取决于[...]	CVP取决于心功能、血容量、静脉血管张力、胸腔内压、静脉回心血量和肺循环阻力
CVP评估[...]	CVP评估右心室前负荷
	Toggle Masks
	Toggle Masks
	Toggle Masks
	Toggle Masks
	Toggle Masks
	Toggle Masks
	Toggle Masks
	Toggle Masks
	Toggle Masks
	Toggle Masks                         Remarks
肺动脉楔压（PAWP）>[...]mmHg提示肺水肿	肺动脉楔压（PAWP）>30mmHg提示肺水肿
心排出量的无创测定方法有哪些	
心排出量的有创测定方法有哪些	
CO监测的临床意义	监测心泵功能：如心率、心律、血液、心脏负荷等判断组织氧供-需平衡
SVO2表示[...]	SVO2表示混合静脉饱和度  Oxygen Saturation of Mixed Venose Blood
DO2表示[...]	DO2表示氧供
VO2表示[...]	VO2表示氧耗
SvO2的正常值是[...]%	SvO2的正常值是70-75%  混合静脉血氧饱和度
左室后负荷用[...]表示。	左室后负荷用外周血管阻力SVR表示。
右室后负荷用[...]表示	右室后负荷用肺血管阻力PVR表示
心力衰竭、心源性休克时交感神经系统和肾素血管紧张素系统张力增加，以维持一定的灌注压，此时SVR[...]	心力衰竭、心源性休克时交感神经系统和肾素血管紧张素系统张力增加，以维持一定的灌注压，此时SVR显著升高  提示全身血管阻力高，可能会影响心脏射血功能和器官组织的血液灌注
PVR是反映[...]的重要指标	PVR是反映肺循环状态的重要指标  肺血管阻力
细胞外液中最主要的阳离子是[...]	细胞外液中最主要的阳离子是Na＋
细胞外液中主要阴离子是[...]	细胞外液中主要阴离子是Cl- ，HCO3-和蛋白质
细胞内液的主要阳离子是[...]	细胞内液的主要阳离子是K＋,Mg2＋
细胞内液主要阴离子是[...]	细胞内液主要阴离子是HPO42- 离子和蛋白质
细胞内外液的[...]相等	细胞内外液的渗透压相等
血钙浓度：[...]mmol/L	血钙浓度：2.25-2.75mmol/L
血液中离子钙的浓度是[...]mmol/L	血液中离子钙的浓度是1.12-1.23mmol/L
血液中钙主要以[...]的形式存在	血液中钙主要以离子的形式存在
在[...]h内血清钠由正常降到[...]mmol/L以下，称为急性低钠血症	在48h内血清钠由正常降到135mmol/L以下，称为急性低钠血症
血清钾浓度低于[...]mmol/L即为低钾血症	血清钾浓度低于3.5mmol/L即为低钾血症
血清钾浓度高于[...]mmol/L即为高钾血症	血清钾浓度高于5.5mmol/L即为高钾血症
低钾血症的诊断	1.血液生化分析：血清钾浓度低于3.5mmol/L 2.临床表现： ①心血管 ②骨骼肌 ③消化系统 ④中枢神经系统
低钾血症时心血管的临床表现	心肌收缩力降低、心脏传导异常，可见期前收缩、心动过速、室颤
低钾血症时骨骼肌的临床表现为	骨骼肌无力、 腱反射迟钝或消失、 严重者可出现肌麻痹、呼吸困难
低钾血症时消化系统的临床表现为	腹胀、便秘、严重者出现麻痹性肠梗阻。
低钾血症时中枢神经系统的临床表现	烦躁不安、情绪激动、精神不振、嗜睡，严重者发生神志障碍
低钾血症的治疗	(1)慎用可进一步降低血钾的药物和治疗措施 (2)治疗原发病 (3)补钾： 可进食、轻症选择口服； 不能口服、重症选择静脉输注
低钾血症的补钾步骤	①监测尿量，无尿病人应慎补钾； ②补钾应先快后慢，成人可以10-20mmol/h的速度补钾使用输液泵并监测心电图； ③碱中毒，纠正低钾后可纠正；      酸中毒，应在纠正酸中毒前补足钾； ④若合并镁异常亦应同时纠正。 ⑤补钾过程中定期监测血钾水平
高钾血症的临床表现	心血管系统 神经肌肉系统 消化系统 中枢神经系统
高钾血症心血管系统的临床表现	心肌抑制作用： 收缩力降低、 兴奋性降低、 传导慢、 自律性降低，严重者心律失常、心搏骤停。
高钾血症神经肌肉系统的临床表现	神经肌肉兴奋性升高 钾过高则兴奋性降低（四肢躯干麻木、甚至瘫软、呼吸肌麻痹）。
高钾血症消化系统的临床表现	恶心         呕吐         腹痛
高钾血症中枢神经系统的临床表现	神志淡漠、迟钝、嗜睡、昏睡
高钾血症的治疗	钙剂 促钾内流 促钾排泄 限钾摄入 治疗原发病
高钾血症时补充钙剂的目的	对抗高钾血症对心脏的抑制
高钾血症时如何促进钠离子进入细胞内（促钠内流）	静脉输注葡萄糖、胰岛素、 碳酸氢钠和/或 β-肾上腺素能激动剂(如舒喘灵)
高钾血症时如何促钾排泄？	静脉给予利尿剂、醛固酮激动剂（如氟氢可的松），肾功能不全者可行肾脏替代治疗
高钾血症时如何限钾摄入？	限制钾的摄入、避免应用库存血
CaO2是[...]	CaO2是动脉血氧含量
SpO2表示[...]	SpO2表示血氧饱和度
O2ER表示[...]	O2ER表示氧摄取率
PaO2/FiO2表示[...]	PaO2/FiO2表示氧合指数
ARDS第一期的临床表现	呼吸频率↑、PaO2正常、PaCO2↓、胸片阴性
ARDS第二期的临床症状	呼吸困难、干湿啰音、Pa02↓、肺纹理增多胸片细网状浸润影
ARDS第三期的临床表现	呼吸窘迫、发绀、啰音↑、心率↑、Pa02进一步↓ 胸片典型弥漫性雾状浸润影
ARDS第四期的临床表现	严重缺氧、嗜睡、谵妄、昏迷、严重低氧、高C02血症、心衰、休克、胸片大片状阴影（毛玻璃状）
PACU指[...]	PACU指麻醉后监护室
严重高血压患者（收缩压＞200mmHg,舒张压＞115mmHg）建议暂缓择期手术，直至血压控制至[...]mmHg	严重高血压患者（收缩压＞200mmHg,舒张压＞115mmHg）建议暂缓择期手术，直至血压控制至180/110mmHg
当FVC＜[...]ml/Kg时，术后肺部并发症的发生率常明显增加	当FVC＜15ml/Kg时，术后肺部并发症的发生率常明显增加  FVC：用力肺活量
抗血小板聚集药物术前至少停药[...]周，停药期间采用[...]替代治疗	抗血小板聚集药物术前至少停药一周，停药期间采用低分子肝素替代治疗
糖尿病患者术前空腹血糖应控制在[...]mmol/L,最高不超过[...]mmol/L	糖尿病患者术前空腹血糖应控制在8.3mmol/L,最高不超过11.1mmol/L
对难以控制的高血糖，至少应降至[...]mmol/L，尿糖（[...]），尿酮体（[...]）	对难以控制的高血糖，至少应降至13.3mmol/L，尿糖（-），尿酮体（-）
CRI是指[...]	CRI是指Goldman心脏危险指数
临床上简易判断病人当前心肺储备能力的方法是[...]	临床上简易判断病人当前心肺储备能力的方法是代谢当量或运动耐量试验
EF＜[...]%表明冠心病患者有中度心血管风险	EF＜35%表明冠心病患者有中度心血管风险  EF：心脏射血分数
什么是MAC？	最低肺泡有效浓度，在1个大气压下吸入麻醉药与纯氧同时吸入时，使50%病人在切皮时无体动的最低肺泡浓度。
MAC越小，麻醉效能越[...]	MAC越小，麻醉效能越强
吸入麻醉药的强度以[...]衡量	吸入麻醉药的强度以最低肺泡有效浓度（MAC）衡量
吸入麻醉药的强度与其[...]成正比	吸入麻醉药的强度与其油/气分配系数成正比  分配系数也称作溶解度
吸入麻醉药的[...]与其血/气分配系数成反比	吸入麻醉药的可控性与其血/气分配系数成反比  此系数值越大，表示该毒物经肺吸收越快，但在血中达到饱和所需时间越长。 越小，在血中达到饱和所需时间越短，能更快进入中枢
吸入麻醉药的可控性与其[...]成反比	吸入麻醉药的可控性与其血/气分配系数成反比  此系数值越大，表示该毒物经肺吸收越快，但在血中达到饱和所需时间越长。 越小，在血中达到饱和所需时间越短，能更快进入中枢
吸入麻醉药的[...]与其油/气分配系数成正比	吸入麻醉药的强度与其油/气分配系数成正比  分配系数也称作溶解度
用于小儿麻醉诱导的吸入麻醉药是[...]	用于小儿麻醉诱导的吸入麻醉药是七氟烷
有癫痫病史者慎用的吸入麻醉药是[...]	有癫痫病史者慎用的吸入麻醉药是恩氟烷
血/气分配系数最低的吸入麻醉药是[...]	血/气分配系数最低的吸入麻醉药是地氟烷
用于短小手术和门诊手术病人的吸入麻醉药是[...]	用于短小手术和门诊手术病人的吸入麻醉药是地氟烷
无刺激气味的吸入麻醉药是[...]	无刺激气味的吸入麻醉药是七氟烷
可用于控制性降压的吸入麻醉药是[...]	可用于控制性降压的吸入麻醉药是异氟烷  异氟烷有明显的外周血管扩张作用
易溶于水，水溶液呈酸性的静脉麻醉药是[...]	易溶于水，水溶液呈酸性的静脉麻醉药是氯胺酮
反复用药可抑制肾上腺皮质功能的静脉麻醉药是[...]	反复用药可抑制肾上腺皮质功能的静脉麻醉药是依托咪酯
作用维持时间短，停药后苏醒快而完全的静脉麻醉药是[...]	作用维持时间短，停药后苏醒快而完全的静脉麻醉药是丙泊酚
对心血管系统影响小，对重危病人有益的静脉麻醉药是[...]	对心血管系统影响小，对重危病人有益的静脉麻醉药是咪达唑仑
超短效巴比妥类静脉麻醉药是[...]	超短效巴比妥类静脉麻醉药是硫喷妥钠
对循环抑制明显的静脉麻醉药是[...]	对循环抑制明显的静脉麻醉药是丙泊酚
适用于缺血性心脏病病人的肌肉松弛药是[...]	适用于缺血性心脏病病人的肌肉松弛药是维库溴铵
[...]首次注药后可由肌纤维成束震颤	去极化肌松药首次注药后可由肌纤维成束震颤
起效时间最快的肌松药是[...]	起效时间最快的肌松药是罗库溴铵
代谢途径由霍夫曼降解的肌松药是[...]	代谢途径由霍夫曼降解的肌松药是顺阿曲库铵  由霍夫曼降解，不依赖肝肾代谢
超短效镇痛药的麻醉性镇痛药是[...]	超短效镇痛药的麻醉性镇痛药是瑞芬太尼
普鲁卡因的作用时间[...]h	普鲁卡因的作用时间0.75-1h
丁卡因的作用时间[...]小时	丁卡因的作用时间2-3小时
利多卡因的作用时间是[...]h	利多卡因的作用时间是1-2h
布比卡因的作用时间[...]h	布比卡因的作用时间5-6h
罗哌卡因的作用时间是[...]h	罗哌卡因的作用时间是4-6h
局部浸润起效时间最快的局麻药是[...]	局部浸润起效时间最快的局麻药是普鲁卡因
单选题： 蛛网膜下隙穿刺成人应选择第（）以下间隙    A第1腰椎  B第2腰椎  C第3腰椎  D第4腰椎  E第5腰椎 B	单选题： 蛛网膜下隙穿刺成人应选择第（）以下间隙   A第1腰椎  B第2腰椎  C第3腰椎  D第4腰椎  E第5腰椎 B      正确答案：                 正确率：100%     解析
硬膜外间隙测试方法	阻力消失法 毛细管负压法 气泡压缩实验
动脉血压的测定方法	1.无创监测 手动听诊测压法 自动间断测压法 2.有创直接测量
国际无创血压测量的金标准是	手动听诊测压法
中心静脉压的临床意义	CVP取决于心功能、血容量、静脉血管张力、胸腔内压、静脉回心血量和肺循环阻力  反映右心室对回心血量的排出能力  评估右心室前负荷
呼吸性酸中毒的临床表现	中枢神经系统 心血管系统 高钾血症
呼吸性酸中毒时中枢神经系统的临床表现	焦虑、定向力障碍、意识混乱、呼吸困难等 1.PaCO2过高(>70mmHg) 可导致CO2麻醉，表现为嗜睡、木僵甚至昏迷；全麻病人会出现苏醒延迟。 2.高碳酸血症 可致脑血管扩张， 出现颅内压升高， 如头痛、反应迟钝、视神经乳头水肿等。
呼吸性酸中毒时心血管系统的临床表现	1.交感肾上腺系统兴奋 表现为高血压、心动 过速、心排出量增加 等循环高动力状态 2.负性肌力作用 表现为低血压、心排出量降低等循环抑制状态
呼吸性酸中毒的治疗	目的是去除诱因，改善肺泡通气功能，使PaCO2恢复至基础水平。例如面罩辅助呼吸或机械控制呼吸， 拮抗全麻用药的残留作用等。同时给与氧治疗以纠正低氧血症
呼吸性酸中毒的血气检查结果	动脉血pH<7.35、PaCO2>44mmHg
代谢性酸中毒的血气分析	动脉血pH<7.35，同时[HCO3-]<20mmol/L或BE<-3mmol/L
代谢性酸中毒的临床表现	中枢神经系统呼吸系统心血管系统长期或急性代酸
代谢性酸中毒中枢神经系统的临床表现	疲乏、嗜睡、意识模糊、甚至昏迷
代谢性酸中毒呼吸系统的临床表现	通气量增加、损坏肌肉收缩力、严重者呼吸衰竭。
代谢性酸中毒心血管系统的临床表现	早期：交感兴奋    当pH<7.2时：收缩力降低、外周血管扩张、 血压下降、加重乳酸酸中毒
代谢性酸中毒时长期或急性代酸	长期代酸： K+耗竭、一旦纠酸，导致低钾血症 急性酸中毒： 导致血红蛋白携氧及输氧能力降低
代谢性酸中毒的治疗	1.一般治疗：保持气道通畅、维持循环稳定和给O2等 2.对因治疗： ①严重的代谢性酸中毒需要补充HCO3- ②pH>7.2：无需补充碳酸氢钠；PH<7.2：应综合分析pH和[HCO3-]情况而定 ③[HCO3-]<15mmol/L：需要给予治疗。 ④纠酸同时注意补K+：随着酸血症纠正，K+向细胞内流动可加重低钾血症
液体治疗的最终目标	避免输液不足引起的隐匿性低血容量、组织低灌注和输液过多引起的心功能不全和外周组织水肿。保证适宜的血容量和麻醉深度，对抗手术创伤可能引起的损害，保证组织灌注满意和器官功能正常。
液体治疗的处理原则	优先补充血容量 术中失血的处理 合理选择溶液制剂 确定输液的顺序与速度
每U红细胞约使Hb提升[...]g/L	每U红细胞约使Hb提升5g/L
单选题： 哪项不是呼吸性酸中毒的病因    A  中枢性呼吸抑制  B  CO2产生过少   C  通气功能障碍  D  无效腔通气增加   E  恶性高热 B	单选题： 哪项不是呼吸性酸中毒的病因   A  中枢性呼吸抑制  B  CO2产生过少   C  通气功能障碍  D  无效腔通气增加   E  恶性高热 B      正确答案：                 正确率：100%     解析：恶性高热会使CO2产生过多
单选题： 高钾血症的治疗措施包括    A  使用钙剂对抗高血钾引起心肌抑制  B  静脉输注葡萄糖、胰岛素、碳酸氢钠和β受体激动剂促进K+内流  C  给予利尿剂、醛固酮促进的K+排泄   D  限制K+的摄入  E   以上全都对 E	单选题： 高钾血症的治疗措施包括   A  使用钙剂对抗高血钾引起心肌抑制  B  静脉输注葡萄糖、胰岛素、碳酸氢钠和β受体激动剂促进K+内流  C  给予利尿剂、醛固酮促进的K+排泄   D  限制K+的摄入  E   以上全都对 E      正确答案：                 正确率：100%     解析
ARDS的治疗原则之如何控制原发病与感染	1、原发病治疗       2、抗感染与控制炎性反应治疗
ARDS的治疗原则之如何呼吸支持支持治疗	1、氧疗：难以奏效 2、机械通气治疗：维持氧合，减少呼吸机相关肺损伤  (1)机械通气的方式  (2)机械通气的管理 3、体外膜肺氧合
ARDS的治疗之呼吸支持治疗的机械通气方式	1) 无创机械通气             2) 有创机械通气
ARDS的治疗原则之机械通气的管理	1)FiO2：维持SpO2 88%-95%、PaO2 55-80mmHg     2)通气模式：容量性控制通气和压力控制通气    3)体位：病人平卧易患呼吸机相关性肺炎（VAP） 机械通气病人应30°-45°半卧位   4)镇静、镇痛，防止躁动，降低氧耗  5)保留适度的自主呼吸  6)肺保护性通气策略  7)部分液体通气：在常规机械通气的基础上经气管插管向肺内注入相当于功能残气量的全氟碳化合物、以降低肺泡表面张力
肺保护性通气策略	①PEEP：复张肺泡、PaO2↑、个体化    ②小潮气量容许性高碳酸血症：4-7ml/kg、60-80mmHg          ③肺复张策略：控制性肺膨胀、PEEP递增法、压力控制法
ARDS的治疗原则之药物治疗	1、糖皮质激素 2、NO吸入 3、肺泡表面活性物质     4、前列腺素E1            5、鱼油    6、其他
局麻药的pKa越大，起效时间越[...]	局麻药的pKa越大，起效时间越长  局麻药越不易透过神经鞘和膜
局麻药的蛋白质结合率越高，其作用时间越[...]	局麻药的蛋白质结合率越高，其作用时间越长
对于清醒患者来说，[...]症状常为局麻药中毒反应的先兆	对于清醒患者来说，中枢神经系统症状常为局麻药中毒反应的先兆
酯类局麻药有哪些	普鲁卡因、丁卡因
酰胺类局麻药有哪些	罗哌卡因
可用于治疗心率失常的局麻药是	利多卡因
硬膜外阻滞术中患者的管理应注意	血压下降、呼吸抑制、恶心呕吐
阻滞平面是指[...]阻滞平面	阻滞平面是指痛觉神经阻滞平面
胸12脊神经对应的解剖部位为[...]	胸12脊神经对应的解剖部位为耻骨联合上缘
局麻药在硬膜外腔广泛扩散见于[...]人	局麻药在硬膜外腔广泛扩散见于动脉硬化的老年人
侧入穿刺发行蛛网膜下腔阻滞时，穿刺针通过的唯一韧带是[...]	侧入穿刺发行蛛网膜下腔阻滞时，穿刺针通过的唯一韧带是黄韧带
椎管内麻醉时，引起血压下降的主要因素是[...]	椎管内麻醉时，引起血压下降的主要因素是交感神经阻滞
脊麻下行剖宫产术，发生严重低血压的原因是[...]	脊麻下行剖宫产术，发生严重低血压的原因是下腔静脉受压
足月孕妇硬膜外阻滞时，麻醉平面扩散较广的主要机制是[...]	足月孕妇硬膜外阻滞时，麻醉平面扩散较广的主要机制是硬膜外间隙有效容积减少
硬膜外麻醉使用试验剂量的主要目的是判断[...]	硬膜外麻醉使用试验剂量的主要目的是判断药物是否在硬膜外隙  排除以外进入蛛网膜下隙的可能
大量利多卡因误入蛛网膜下腔的危险是[...]	大量利多卡因误入蛛网膜下腔的危险是呼吸麻痹
为防止误入蛛网膜下腔，骶管穿刺针尖深度不应超过[...]	为防止误入蛛网膜下腔，骶管穿刺针尖深度不应超过第二骶椎平面
蛛网膜下腔阻滞的主要禁忌症	
如何判断穿刺针已进入硬膜外间隙	穿刺针到达黄韧带后，阻力突然消失负压现象无脑脊液流出
简述椎管内麻醉后不同神经纤维阻滞顺序	血管舒缩神经纤维→冷感消失→温感消失→对不同温度的辨别→慢痛→快痛→触觉消失→运动麻痹→压力感消失→本体感消失
硬膜外阻滞并发症治疗效果差的是[...]	硬膜外阻滞并发症治疗效果差的是硬膜外脓肿
腰麻尿潴留常发生在[...]的阻滞	腰麻尿潴留常发生在S2-S4的阻滞
减少术中知晓，BIS应该控制在[...]水平	减少术中知晓，BIS应该控制在40-60水平
全麻拔管后发生通气不足，主要表现为[...]	全麻拔管后发生通气不足，主要表现为CO2潴留
麻醉诱导最快的吸入性麻药是[...]	麻醉诱导最快的吸入性麻药是地氟烷
肠梗阻手术中不宜使用的吸入性麻药是[...]	肠梗阻手术中不宜使用的吸入性麻药是氧化亚氮  氧化亚氮能使体内封闭腔内压升高，如腹内压、胸内压
能被胆碱酯酶降解的肌松药是[...]	能被胆碱酯酶降解的肌松药是琥珀胆碱  琥珀胆碱与乙酰胆碱结构相似
眼球穿孔伤时不宜使用的肌松药是[...]	眼球穿孔伤时不宜使用的肌松药是琥珀胆碱  琥珀胆碱可引起肌强直，导致眼压升高
高血钾患者不宜使用的肌松药是[...]	高血钾患者不宜使用的肌松药是琥珀胆碱  广泛骨骼肌去极化过程中，可引起血清钾升高
对心血管功能影响轻微，血流动力学稳定的静脉麻醉药是[...]	对心血管功能影响轻微，血流动力学稳定的静脉麻醉药是依托咪酯
麻醉导致呼吸性碱中毒的原因有哪些？	机械通气过度，呼吸兴奋剂的使用，麻醉过浅或效果不佳
麻醉导致代谢性酸中毒的主要原因有哪些？	某些麻醉药物的影响，术前禁食，术中缺氧，低血压及大量输注库存血
代谢性酸中毒的诊断	是否存在代谢性酸中毒呼吸系统反应是否正常。如果PaCO2不能恢复至适当水平，提示患者同时存在呼吸性酸碱平衡紊乱是否存在无血浆阴离子间隙增加的代谢性酸中毒
阴离子间隙(AG)的正常值[...]mmol/L 无论PH是否正常，AG＞[...]mmol/L即可诊断为代谢性酸中毒	阴离子间隙(AG)的正常值8-16mmol/L 无论PH是否正常，AG＞16mmol/L即可诊断为代谢性酸中毒
麻醉导致代谢性碱中毒的原因有哪些	某些碱性药物用量过大，大量输血后血中枸橼酸钠含量增高，麻醉后呕吐等  （库存血中含有大量的抗凝剂枸橼酸钠，这种物质是碱性的，在肝脏代谢就会转化为碳酸氢钠）
代谢性碱中毒最严重的后果是[...]	代谢性碱中毒最严重的后果是呼吸抑制导致通气量不足和PaCO2升高
慢性腹泻患者易发生高[...]性代谢性[...]中毒	慢性腹泻患者易发生高氯性代谢性酸中毒
出现CO2蓄积的早期征象是[...]	出现CO2蓄积的早期征象是面部潮红
控制性降压一般在[...]下进行，便于呼吸管理	控制性降压一般在全身麻醉下进行，便于呼吸管理
手术牵拉内脏所致的低血压， 应暂停手术操作，并静注少量[...]提升血压，注入[...]预防和减轻神经反射引起的心动过缓	手术牵拉内脏所致的低血压， 应暂停手术操作，并静注少量黄麻碱提升血压，注入阿托品预防和减轻神经反射引起的心动过缓
围术期，嗜铬细胞瘤引起的高血压首选的降压药物是[...]； 切除瘤体后引起的低血压首选的升压药物是[...]	围术期，嗜铬细胞瘤引起的高血压首选的降压药物是酚妥拉明； 切除瘤体后引起的低血压首选的升压药物是去甲肾上腺素
围手术期发生低血容量性休克最常见的原因是[...]	围手术期发生低血容量性休克最常见的原因是手术创伤和失血
控制性降压药物： 可引起代谢产物氰化物蓄积，导致细胞缺氧的是[...]	控制性降压药物： 可引起代谢产物氰化物蓄积，导致细胞缺氧的是硝普钠
控制性降压药物： 椎管内麻醉引起的低血压首选的药物是[...]	控制性降压药物： 椎管内麻醉引起的低血压首选的药物是麻黄碱
控制性降压药物： 心动过速可选用的药物是[...]	控制性降压药物： 心动过速可选用的药物是艾司洛尔
肺动脉压是反映[...]的重要指标	肺动脉压是反映右心室后负荷的重要指标
肺动脉平均压（MPAP）的正常值为[...]mmHg	肺动脉平均压（MPAP）的正常值为10-25mmHg
静息时MPAP超过[...]mmHg或动态下超过[...]mmHg即可诊断为肺动脉高压	静息时MPAP超过25mmHg或动态下超过30mmHg即可诊断为肺动脉高压  MPAP：肺动脉平均压
肺动脉楔压间接反映[...]负荷	肺动脉楔压间接反映左心室前负荷
肺动脉楔压（PAWP）的正常值是[...]mmHg	肺动脉楔压（PAWP）的正常值是5-12mmHg
[...]决定冠状动脉灌注压	舒张压决定冠状动脉灌注压
无主动脉瓣狭窄时，[...]可反应左心室最大压力	无主动脉瓣狭窄时，收缩压可反应左心室最大压力
	Toggle Masks
	Toggle Masks
补充血容量： ①总体液无明显不足，但有效循环血容量不足。这时主要补充[...]液 ②总体液不足，有效循环血流也不足。首先要纠正有效循环血流的不足，以补充[...]液为主。	补充血容量： ①总体液无明显不足，但有效循环血容量不足。这时主要补充胶体液 ②总体液不足，有效循环血流也不足。首先要纠正有效循环血流的不足，以补充胶体液为主。
每单位浓缩血小板可使血小板增加（[...]）×109/L	每单位浓缩血小板可使血小板增加（7.5-10）×109/L
麻醉中出现血压下降，心率加快，首先考虑[...]	麻醉中出现血压下降，心率加快，首先考虑血容量不足
术前贫血病人最常见的贫血原因是[...]	术前贫血病人最常见的贫血原因是缺铁
[...]是治疗缺铁性贫血的有效措施	静脉补充铁剂是治疗缺铁性贫血的有效措施
静脉补充铁剂的不良反应主要是[...]	静脉补充铁剂的不良反应主要是过敏
择期手术病人术前[...]天应进行血红蛋白水平的测量	择期手术病人术前28天应进行血红蛋白水平的测量
主动脉内球囊阻断术常用于[...]手术	主动脉内球囊阻断术常用于骶尾部肿瘤和骨盆肿瘤的切除、高出血风险的产科手术  骶尾部、骨盆和脊柱无法安置止血带
手术室室温通常为[...]℃	手术室室温通常为22-24℃  温度低于35℃，血小板聚集的功能降低，凝血因子也无法发挥正常功能
在口服华法林病人行急诊手术前可应用[...]紧急对抗华法林抗凝血作用	在口服华法林病人行急诊手术前可应用FFP紧急对抗华法林抗凝血作用  FFP：新鲜冰冻血浆
什么是冷沉淀？	是单份FFP在4±2℃下融化后的沉淀部分，含有较高浓度的VIII因子和纤维蛋白原
冷沉淀主要用于[...]型血友病	冷沉淀主要用于甲型血友病  甲型血友病：VIII因子缺乏
凝血酶原复合物（PCC）含有丰富的凝血[...]因子，可有效治疗血友病[...]	凝血酶原复合物（PCC）含有丰富的凝血IX因子，可有效治疗血友病B
术前未停用华法林的病人在进行手术前可以紧急使用[...]	术前未停用华法林的病人在进行手术前可以紧急使用PCC  PCC：凝血酶原复合物
自体血液回收：回输的血液中仅含有[...]细胞	自体血液回收：回输的血液中仅含有红细胞
上腹部手术通常会使肺活量/功能残气量下降，一般[...]天后能恢复到麻醉前水平	上腹部手术通常会使肺活量/功能残气量下降，一般10-14天后能恢复到麻醉前水平
全麻恢复期患者血压偏低最常见的原因是[...]	全麻恢复期患者血压偏低最常见的原因是血容量不足
全麻清醒期患者高血压最常见的原因是[...]	全麻清醒期患者高血压最常见的原因是疼痛
全麻患者清醒前最重要的护理是[...]	全麻患者清醒前最重要的护理是去枕平卧，头偏向一侧
PaO2/FiO2的正常值是[...]	PaO2/FiO2的正常值是400-500
血管外肺水在胸腔内血容量所占的比例，即肺通透性指数的正常值为[...]%	血管外肺水在胸腔内血容量所占的比例，即肺通透性指数的正常值为20-30%
柏林会议对ARDS的诊断限定的发病时间范围是[...]	柏林会议对ARDS的诊断限定的发病时间范围是原始创伤后1周内
采用肺保护性通气策略时潮气量范围是[...]ml/kg	采用肺保护性通气策略时潮气量范围是6-8ml/kg
采用肺保护性通气策略时平台压应小于[...]cmH2O	采用肺保护性通气策略时平台压应小于30cmH2O
肺毛细血管渗漏综合征： 支气管液与血浆蛋白渗透压的比值＞[...]%	肺毛细血管渗漏综合征： 支气管液与血浆蛋白渗透压的比值＞75%
当FiO2增加[...]，而PaO2上升 10mmHg时，称为顽固性低氧血症，是肺内真正分流增加的结果	当FiO2增加0.20，而PaO2上升 10mmHg时，称为顽固性低氧血症，是肺内真正分流增加的结果
当FiO2增加0.20，而PaO2上升 [...]mmHg时，称为顽固性低氧血症，是肺内真正分流增加的结果	当FiO2增加0.20，而PaO2上升 10mmHg时，称为顽固性低氧血症，是肺内真正分流增加的结果
低流量系统供养时，鼻导管吸氧法吸入2L/min的氧气，其FiO2为[...]	低流量系统供养时，鼻导管吸氧法吸入2L/min的氧气，其FiO2为0.28
在氧治疗时，安全的氧气浓度应该低于[...]%	在氧治疗时，安全的氧气浓度应该低于50%  氧治疗可能引起吸收性肺不张
心肺复苏人工呼吸的频率：[...]次/min	心肺复苏人工呼吸的频率：10次/min
基本生命支持的主要措施：[...]	基本生命支持的主要措施：胸外心脏按压和人工呼吸
成人基本生命支持的基本内容：	识别心搏骤停和启动紧急医疗服务系统（EMSs）即时高质量心肺复苏快速除颤先除颤后按压
单人实施CPR时，婴儿、儿童和成人均连续胸部按压[...]次后，再给予[...]次人工呼吸	单人实施CPR时，婴儿、儿童和成人均连续胸部按压30次后，再给予2次人工呼吸  30:2
双人实施CPR时，成人按压通气比为[...]； 婴儿和儿童按压通气比为[...]	双人实施CPR时，成人按压通气比为30:2； 婴儿和儿童按压通气比为15：2
新生儿复苏，按压通气比为[...]	新生儿复苏，按压通气比为3:1  每分钟90次按压和30次呼吸
胸外心脏按压的部位为[...]	胸外心脏按压的部位为胸骨下部或剑突以上4-5cm处
胸外心脏按压的频率：[...]	胸外心脏按压的频率：100-120次/分
胸外心脏按压的深度：[...]	胸外心脏按压的深度：5-6cm
临床上心脏按压有效的标准	可触及大动脉搏动皮肤由青紫转为红润可测得血压散大的瞳孔开始缩小，出现自主呼吸
心搏骤停病人发生呼吸道梗阻最常见的原因是[...]，可用[...]法解除	心搏骤停病人发生呼吸道梗阻最常见的原因是舌后坠，可用仰头抬颏法解除  仰头抬颏法解除舌后坠效果最佳且安全
胸外电除颤时，将一电极板放在[...]，另一电极板置于[...]。	胸外电除颤时，将一电极板放在胸骨右缘第3肋间，另一电极板置于左腋前线，心尖下方。
CPR间期给药途径	静脉给药：首选中心静脉置管 骨内给药 气管内滴注 心室内给药
CPR期间的常用药物	肾上腺素（首选）胺碘酮利多卡因碳酸氢钠β受体阻滞剂
胺碘酮对治疗[...]都有效	胺碘酮对治疗房性和室性心律失常都有效
如果心室纤颤或无脉性室速对电除颤、CPR或血管加压药无效，可应用[...]	如果心室纤颤或无脉性室速对电除颤、CPR或血管加压药无效，可应用胺碘酮
利多卡因适用于治疗[...]	利多卡因适用于治疗室性期前收缩和阵发性室性心动过速
除颤后又复发心室纤颤而需反复除颤的患者，可应用[...]	除颤后又复发心室纤颤而需反复除颤的患者，可应用利多卡因
若是因心室纤颤或无脉性室速导致心搏骤停病人，恢复自主循环后可以考虑应用[...]	若是因心室纤颤或无脉性室速导致心搏骤停病人，恢复自主循环后可以考虑应用利多卡因
高级生命支持对气道的管理最佳的选择是[...]	高级生命支持对气道的管理最佳的选择是气管内插管
脑死亡的患者是脑的哪部分功能丧失了？	全脑的所有功能不可逆性丧失，特别是脑干功能的丧失
MODS最先受损的器官是[...]	MODS最先受损的器官是肺
什么是MODS？	多器官功能障碍综合征，是严重创伤、感染、脓毒症、大手术、大面积烧伤、长时间心肺复苏及病理产科等疾病发生24小时后，出现的两个或两个以上器官先后或同时发生的功能障碍或衰竭，即急性损伤病人多个器官功能代谢不能维持内环境稳定的临床综合征。
MODS的临床诊断方法有哪些？	修正的Fry-MODS诊断标准反映MODS病理生理过程诊断标准疾病特异性MODS评分和诊断系统
国内MODS诊断标准/修正的Fry-MODS诊断标准： 诊断MODS的主要依据是哪些？	创伤、感染、大手术、休克、延迟复苏等诱发MODS的病史存在全身炎性反应综合征、代偿性抗炎反应综合征的临床表现存在两个系统或器官功能障碍
危重病人营养状态评估方法	机体测量参数：皮肤皱褶厚度、上臂中部周长等生化检测指标：如前白蛋白、血红蛋白等体重指数：BMI个体全身评估
当机体的有效循环容量及水、酸碱与电解质平衡得到初步纠正后，即应开始营养支持，一般在治疗开始后[...]小时进行	当机体的有效循环容量及水、酸碱与电解质平衡得到初步纠正后，即应开始营养支持，一般在治疗开始后24～48小时进行
营养支持途径	肠外营养支持 肠内营养支持
营养支持应配合应用胰岛素控制血糖。严格控制血糖水平（≤[...]mmol/L）	营养支持应配合应用胰岛素控制血糖。严格控制血糖水平（≤7.5～9.0mmol/L）
重症患者的营养支持中，一般情况下，葡萄糖的输入量应当控制在≤ [...]g/d	重症患者的营养支持中，一般情况下，葡萄糖的输入量应当控制在≤ 200g/d
三头肌皮肤褶皱厚度 成人平均理想值为男：[...]mm，女：[...]mm	三头肌皮肤褶皱厚度 成人平均理想值为男：12.3mm，女：16.5mm
肠内营养的适应证	胃肠道功能存在（或部分存在），但不能经口正常摄食的重症病人， 应优先考虑给予肠内营养，只有肠内营养不可实施时才考虑肠外营养。
肠外营养的适应证	胃肠道功能障碍的重症病人由于手术或解剖问题胃肠道禁止使用的重症病人存在尚未控制的腹部情况，如腹腔感染、肠梗阻、肠瘘等
肠内营养的禁忌症	肠梗阻、肠道缺血时，肠内营养常造成肠管过度扩张，肠道血运恶化，甚至肠坏死、肠穿孔； 严重腹胀或腹腔间室综合征时，肠内营养增加腹腔内压力，高腹压将增加返流及吸入性肺炎的发生率，并使呼吸循环等功能进一步恶化； 对于严重腹胀、腹泻，经一般处理无改善的病人，建议暂时停用肠内营养。
昏迷、食管梗阻等长时间不能进食，但胃排空良好的重症患者可选用的肠内营养输入途径是[...]	昏迷、食管梗阻等长时间不能进食，但胃排空良好的重症患者可选用的肠内营养输入途径是经皮内镜下胃造口（PEG）
对不耐受经胃营养或有返流和误吸高风险的重症患者，宜选择经[...]营养。	对不耐受经胃营养或有返流和误吸高风险的重症患者，宜选择经空肠营养。
肠内营养的并发症	1.机械性并发症： 粘膜损伤 饲管堵塞 喂养管脱出 2.感染性并发症： 吸入性肺炎 3.胃肠道并发症： 恶心、呕吐、腹胀、肠痉挛、便秘和腹泻等 4.代谢性并发症 高血糖或水、电解质代谢紊乱
经中心静脉实施肠外营养首选[...]置管途径	经中心静脉实施肠外营养首选锁骨下静脉置管途径  锁骨下静脉感染及血栓性并发症均低于股静脉和颈内静脉途径，且便于护理，是首选位置。
临床上[...]的发生是限制周围静脉营养的常见原因。	临床上静脉炎的发生是限制周围静脉营养的常见原因。
ICU患者蛋白质(氨基酸)的需要量供给至少应达到[...]g/(kg·d)	ICU患者蛋白质(氨基酸)的需要量供给至少应达到1.2~1.5g/(kg·d)
肠外营养的并发症	再喂养综合征过度喂养高糖血症电解质紊乱和微量营养素缺乏中心静脉置管并发症脓毒症
疼痛的评估方法	视觉模拟评分法口述描绘评分法数字评分法面部量表
[...]是分娩中最常使用的全身性药物	阿片类药物是分娩中最常使用的全身性药物
产科最常用的镇痛技术是[...]	产科最常用的镇痛技术是硬膜外镇痛
癌症病人为神经病理性疼痛时，应首选[...]药物	癌症病人为神经病理性疼痛时，应首选三环类抗抑郁药物或抗惊厥类药物
癌症病人三阶梯给药方式	轻度疼痛：选用非甾体类抗炎药物（NSAIDs）中度疼痛：选用弱阿片类药物，并合用NSAIDs重度疼痛：选用强阿片类药，并可联用NSAIDs
癌痛药物止痛的原则	口服给药 按阶梯用药 按时用药 个体化给药 注意药物联合的作用
依赖性药物的分类	麻醉药品精神药品其它：乙醇、烟草等
[...]是治疗和预防术中支气管痉挛的有效药物	β2肾上腺素受体激动药、白三烯受体阻断剂是治疗和预防术中支气管痉挛的有效药物
控制性降压的并发症	脑栓塞与脑缺氧冠状动脉供血不足，心肌梗死，心力衰竭甚至心搏骤停急性肾损伤血管栓塞降压后反跳性出血持续性低血压、休克嗜睡、苏醒延迟或苏醒后精神障碍呼吸功能障碍失明等
局麻药的种类	1.按化学结构分类 酯类局麻药 酰胺类局麻药 2.按作用时间分类 短效局麻药 中效局麻药 长效局麻药
麻醉手术液体丢失有哪些方面	术前机体的液体缺失，主要是术前禁食和病人术前存在非正常的液体丢失麻醉导致的血管扩张或相对血容量不足手术期间的生理需要量手术出血手术创伤引起的体液向第三间隙分布
	Toggle Masks
	Toggle Masks
	Toggle Masks
影响局麻药药理作用的因素	1.用药方式 局麻药的剂量 局麻药的注射部位 添加其他药物 2.病人因素 病人的年龄 病人的重要器官功能 妊娠
影响气道通畅的常见原因	分泌物、出血、血凝块及异物舌后坠喉痉挛支气管痉挛药物残余作用所致通气障碍
机械通气模式	控制通气辅助通气辅助-控制通气压力支持通气压力释放通气压力调节容积控制通气同步间歇指令通气分钟指令通气适应性支持通气双相气道正压
中心静脉穿刺的途径	经右颈内静脉或右锁骨下静脉穿刺置管进入上腔静脉，左颈内静脉及股静脉也可选用
硬膜外麻醉的禁忌症	严重贫血、高血压病、心脏代偿功能不良者慎用；严重休克患者、穿刺部位有炎症或感染病灶者应禁用；呼吸困难的病人不宜选用颈、胸段硬膜外阻滞。
局部麻醉方式	狭义： 表面麻醉 局部浸润麻醉 区域阻滞麻醉 静脉局部麻醉 神经阻滞麻醉 广义： 还包括蛛网膜下腔阻滞 硬膜外阻滞 骶管阻滞
影响肺泡药物浓度的因素有哪些？	通气效应 浓度效应 心排出量 血/气分配系数 麻醉药在肺泡和静脉血中的浓度差
静脉麻醉的优点和缺点	优点：诱导快、对呼吸道无刺激、无环境污染 缺点：麻醉药物代谢受肝肾功能的影响，可控制性差，往往需要复合用药。
全身麻醉的适应证	全身麻醉药用于大型手术或不能用局部麻醉药的患者
困难气道评估的检查	咽部结构分级张口度甲颏距离颞颌关节活动度头颈部活动度喉镜显露分级
常用麻醉前用药有哪几种？	1)镇痛药：吗啡、哌替啶、芬太尼 2)苯二氮卓类：地西泮、咪达唑仑 3)α2肾上腺素受体激动药：右美托咪定 4)抗胆碱药：阿托品、东莨菪碱 5) H2受体阻断剂：西咪替丁、雷尼替丁
围术期影响体温的因素	1.病人因素 小儿、老年人体温调节能力差 2.环境因素 室温对体温的影响 3.麻醉因素 ①全身麻醉对体温调节的影响 机体的行为性体温调节减弱或消失，自主性体温调节被抑制 ②椎管内麻醉对体温调节的影响 正常的体温调节反应被抑制 4.手术及输血、输液因素
什么是分娩镇痛	在分娩过程中由麻醉医师提供的镇痛技术和生命体征监测，为母婴提供安全、舒适的分娩条件
肌松药的分类	1.去极化肌松药 琥珀胆碱 2.非去极化肌松药 筒箭毒碱
有创动脉穿刺的并发症	动脉栓塞肢端缺血出血血肿动脉瘤形成动静脉瘘感染周围神经损伤等
感染性休克的治疗	控制感染和原发病的治疗早期复苏改善心肌收缩力血管活性药物的应用加强呼吸管理和呼吸治疗纠正电解质紊乱和酸碱平衡失常糖皮质激素
术前怎样评估呼吸功能	1.一般评估方法： 根据相关病史和体征排除有无呼吸道的急、慢性感染； 有无哮喘病史，是否属于气道高反应性病人； 对于并存有COPD病人，术前需通过各种检查，如胸部影像学检查、肺功能试验、血气分析等来评估病人的肺功能 2.肺功能的评估： 如最大自主通气量、肺活量、动脉血气分析 3.手术部位的影响： 切口临近膈肌时风险增加； 上腹部和开胸手术发生后呼吸系统并发症的风险最大
心搏骤停根据心电图的不同分类	心室纤颤无脉性室性心动过速无脉性心电活动：包括心肌电-机械分离、室性自搏心律、室性逸博心律等心脏静止
高质量的CPR的内容	1.循环支持 胸外心脏按压 开胸心脏按压 2.呼吸支持 呼吸道的管理：仰头抬颏法；托下颌法 人工呼吸：口对口呼吸，简易人工呼吸机
液体治疗常用的晶体液有哪些？	葡萄糖注射液氯化钠注射液乳酸钠林格液醋酸林格液碳酸氢钠溶液
液体治疗常用的胶体液有哪些？	右旋糖酐40羟乙基淀粉琥珀酰明胶高张氯化钠羟乙基淀粉40白蛋白
阿片类药物有哪些	吗啡芬太尼舒芬太尼瑞芬太尼
失血性休克的治疗原则	保证呼吸道畅通和氧合功能治疗原发病，终止体液的继续丢失补充血容量纠正电解质紊乱和酸碱平衡失调
PACU循环系统并发症	术后低血压术后高血压心律失常
结晶水合物而引起麻醉的作用原理，属于[...]法则	结晶水合物而引起麻醉的作用原理，属于Meyer-overton法则
吸收至血内的局麻药主要与血浆中[...]蛋白结合	吸收至血内的局麻药主要与血浆中酸性糖蛋白结合
单选题： 关于体位与肺通气不足的叙述，其严重程度由重到轻，哪一项是正确的    A深度屈氏体位、头低截石位、俯卧位、侧卧位 B深度屈氏体位、俯卧位、头低截石位、侧卧位 C头低截石位、深度屈氏体位、侧卧位、俯卧位 D俯卧位、深度屈氏体位、头低截石位、侧卧位 E俯卧位、头低截石位、深度屈氏体位、侧卧位 A	单选题： 关于体位与肺通气不足的叙述，其严重程度由重到轻，哪一项是正确的   A深度屈氏体位、头低截石位、俯卧位、侧卧位 B深度屈氏体位、俯卧位、头低截石位、侧卧位 C头低截石位、深度屈氏体位、侧卧位、俯卧位 D俯卧位、深度屈氏体位、头低截石位、侧卧位 E俯卧位、头低截石位、深度屈氏体位、侧卧位 A      正确答案：                 正确率：100%     解析
首先将钠石灰用于麻醉的是	Jiuporob
单选题： 关于颈丛阻滞，哪项错误    A肌间沟内注射局麻药，可同时阻滞颈丛及臂丛神经 B颈丛阻滞时C横突定位方法为乳头与胸锁乳头肌胸骨头连线中点 C颈丛为感觉神经，臂丛为混合神经 D颈深丛阻滞时局麻药应注射在横突附近，颈浅丛阻滞注射于皮下、颈阔肌筋膜下 E颈丛阻滞可出现阻滞侧面红无汗现象 A	单选题： 关于颈丛阻滞，哪项错误   A肌间沟内注射局麻药，可同时阻滞颈丛及臂丛神经 B颈丛阻滞时C横突定位方法为乳头与胸锁乳头肌胸骨头连线中点 C颈丛为感觉神经，臂丛为混合神经 D颈深丛阻滞时局麻药应注射在横突附近，颈浅丛阻滞注射于皮下、颈阔肌筋膜下 E颈丛阻滞可出现阻滞侧面红无汗现象 A      正确答案：                 正确率：100%     解析：
Steward清醒程度评分中，完全苏醒分值为[...]分	Steward清醒程度评分中，完全苏醒分值为2分
颈丛阻滞时容易损伤[...]神经	颈丛阻滞时容易损伤喉返神经和膈神经  损伤喉返神经：声音嘶哑或失音，轻度呼吸困难，短时间可自行恢复 损伤膈神经：胸闷呼吸困难，吸氧可缓解
颈丛阻滞的骨性标志是[...]	颈丛阻滞的骨性标志是C4横突
腰麻平面达T4，心率减慢的主要原因是[...]	腰麻平面达T4，心率减慢的主要原因是支配心脏交感神经节前纤维阻滞  交感神经被阻滞，迷走神经相对亢进 可静脉注射阿托品拮抗
腰麻平面超过T4后出现血压下降的原因是[...]	腰麻平面超过T4后出现血压下降的原因是交感神经节前纤维被阻滞  小血管扩张、周围血管阻力下降，血液淤积于周围血管、回心血量减少、心排出量
单选题： 下列哪一项不是肌间沟入路臂丛阻滞的缺点    A.尺神经阻滞起效慢 B.有误入蛛网膜下隙或硬脊膜外隙的危险 C.有损伤椎动脉的危险 D.气胸发生率较高 E.可出现膈神经阻滞 D	单选题： 下列哪一项不是肌间沟入路臂丛阻滞的缺点   A.尺神经阻滞起效慢 B.有误入蛛网膜下隙或硬脊膜外隙的危险 C.有损伤椎动脉的危险 D.气胸发生率较高 E.可出现膈神经阻滞 D      正确答案：                 正确率：100%     解析： A.肌间沟入路臂丛阻滞不能为尺神经分布区的手术提供良好的麻醉效果 BCE都是肌间沟入路的缺点 D是其优点
肌间沟径路臂丛阻滞适用于[...]手术	肌间沟径路臂丛阻滞适用于肩部、上臂和前臂手术
腋路臂神经丛阻滞适用于[...]手术	腋路臂神经丛阻滞适用于肘部至手部手术
气管隆突的高度相当于[...]	气管隆突的高度相当于胸骨角
可引起胸壁肌肉僵硬的是[...]	可引起胸壁肌肉僵硬的是芬太尼
巴比妥类药物的作用位点是[...]受体	巴比妥类药物的作用位点是γ-氨基丁酸受体
近代麻醉学起始与19世纪[...]年代	近代麻醉学起始与19世纪40年代
治疗氯丙嗪引起的直立性低血压首选[...]	治疗氯丙嗪引起的直立性低血压首选去甲肾上腺素
镇静药中[...]可产生顺行性遗忘作用	镇静药中咪达唑仑可产生顺行性遗忘作用  顺行性遗忘作用：即刻记忆完整，事后记忆受损，无逆行性遗忘作用
单选题： 高血压病人的术前准备,以下哪项正确     A.凡舒张压持续超过 100mmHg均给抗高血压药治疗 B.对舒张压超过 110 mmHg 抗高血压药治疗必须延续到手术日晨 C.长期用抗高血压药治疗,如血压稳定,术前 3 天可以停药 D.高血压并存心肌缺血者,择期手术应列为禁忌 E.单纯慢性高血压患者,对麻醉的耐受力较差 B	单选题： 高血压病人的术前准备,以下哪项正确    A.凡舒张压持续超过 100mmHg均给抗高血压药治疗 B.对舒张压超过 110 mmHg 抗高血压药治疗必须延续到手术日晨 C.长期用抗高血压药治疗,如血压稳定,术前 3 天可以停药 D.高血压并存心肌缺血者,择期手术应列为禁忌 E.单纯慢性高血压患者,对麻醉的耐受力较差 B      正确答案：                 正确率：100%     解析
创伤性休克应首选[...]扩容	创伤性休克应首选平衡盐溶液扩容
两肺下界的体表投影，在肩胛线处于第[...]肋相交	两肺下界的体表投影，在肩胛线处于第10肋相交
在Graves病治疗中，能阻断周围组织中T4转化为T3的药物是[...]	在Graves病治疗中，能阻断周围组织中T4转化为T3的药物是甲基硫氧嘧啶
单选题： 导致MODS的危险因素不包括    A.感染 B.器官直接损伤 C.低血容量性休克 D.嗜铬细胞瘤 E.自身免疫性疾病 B	单选题： 导致MODS的危险因素不包括   A.感染 B.器官直接损伤 C.低血容量性休克 D.嗜铬细胞瘤 E.自身免疫性疾病 B      正确答案：                 正确率：100%     解析
在苯二氮卓类药物中，催眠、抗焦虑作用强于地西泮的是[...]	在苯二氮卓类药物中，催眠、抗焦虑作用强于地西泮的是三唑仑
单选题： 关于门德尔森综合征,下列叙述不恰当的是    A.多见于误吸了 pH大于2.5的胃内容物 B.胸片示肺野外周有不规则斑点状阴影 C.肺顺应性降低 D.有通气灌流不足 E.有喘鸣音、血性泡沫痰 A	单选题： 关于门德尔森综合征,下列叙述不恰当的是   A.多见于误吸了 pH大于2.5的胃内容物 B.胸片示肺野外周有不规则斑点状阴影 C.肺顺应性降低 D.有通气灌流不足 E.有喘鸣音、血性泡沫痰 A      正确答案：                 正确率：100%     解析
单选题： 肝功能与电解质代谢有密切关系，肝功能障碍时常发生电解质紊乱，下述哪项错误     A.水潴留 B.低钠血症 C.高钾血症 D.低钙血症 E.低磷血症 C	单选题： 肝功能与电解质代谢有密切关系，肝功能障碍时常发生电解质紊乱，下述哪项错误    A.水潴留 B.低钠血症 C.高钾血症 D.低钙血症 E.低磷血症 C      正确答案：                 正确率：100%     解析
单选题： 贫血可引起的病理生理变化正确的是    A.红细胞比容下降 B.脉细血管通透性降低 C.充血性心力衰竭 D.尿比重增高 E.红细胞渗透性脆性降低 C	单选题： 贫血可引起的病理生理变化正确的是   A.红细胞比容下降 B.脉细血管通透性降低 C.充血性心力衰竭 D.尿比重增高 E.红细胞渗透性脆性降低 C      正确答案：                 正确率：100%     解析
单选题： 呼气储备量等于    A.补吸气量 B.肺活量-深呼气量 C.肺活量-深吸气量 D.肺活量-吸气贮备量 E.潮气量 补吸气量 C	单选题： 呼气储备量等于   A.补吸气量 B.肺活量-深呼气量 C.肺活量-深吸气量 D.肺活量-吸气贮备量 E.潮气量 补吸气量 C      正确答案：                 正确率：100%     解析
单选题： 慢性高钠血症的病人，4～6小时内Posm的降低程度不应大于    A.5～10mOsm/kg B.10～15mOsm/kg C.15～25mOsm/kg D.25～30mOsm/kg E.30～35mOsm/kg E	单选题： 慢性高钠血症的病人，4～6小时内Posm的降低程度不应大于   A.5～10mOsm/kg B.10～15mOsm/kg C.15～25mOsm/kg D.25～30mOsm/kg E.30～35mOsm/kg E      正确答案：                 正确率：100%     解析
可用于解救酒精急性中毒的药物是[...]	可用于解救酒精急性中毒的药物是纳洛酮
单选题： 慢性支气管炎的发生与下列哪项因素最有关    A.肺炎球菌感染 B.腺病毒感染 C.支原体感染 D.真菌感染 E.曲菌感染 B	单选题： 慢性支气管炎的发生与下列哪项因素最有关   A.肺炎球菌感染 B.腺病毒感染 C.支原体感染 D.真菌感染 E.曲菌感染 B      正确答案：                 正确率：100%     解析
血浆中最重要的生理性抗凝物质是[...]	血浆中最重要的生理性抗凝物质是抗凝血酶III  血液中最重要的抗凝物质是抗凝血酶Ⅲ和肝素,抗凝血酶Ⅲ和凝血酶会产生一种一氧化氮合酶,对凝血酶导致降解
单选题： 患者男，60岁。因脑出血局麻下行钻孔引流术。入室表情淡漠，血压140/70mmHg，心率100次/分。静脉给予咪达唑仑2mg，芬太尼0.05mg。患者入睡，手术开始。术中患者血压突然上升至160/90mmHg，心率140次/分，呼吸困难，最可能的原因是    A.药物过敏 B.支气管痉挛 C.误吸 D.麻醉深度不够 E.手术刺激 C	单选题： 患者男，60岁。因脑出血局麻下行钻孔引流术。入室表情淡漠，血压140/70mmHg，心率100次/分。静脉给予咪达唑仑2mg，芬太尼0.05mg。患者入睡，手术开始。术中患者血压突然上升至160/90mmHg，心率140次/分，呼吸困难，最可能的原因是   A.药物过敏 B.支气管痉挛 C.误吸 D.麻醉深度不够 E.手术刺激 C      正确答案：                 正确率：100%     解析：合并中枢神经系统病变的患者对镇静药比较敏感，深度镇静下咽喉部反射减弱，容易造成误吸
[...]是肺动脉压	PAP是肺动脉压  Pulmonary artery pressure
PAP是[...]	PAP是肺动脉压  Pulmonary artery pressure
PCWP是指[...]	PCWP是指肺毛细血管楔压  pulmonary capillary wedge pressure
RAP是指[...]	RAP是指右房压   right atrial pressure
右心房压力（RAP）的正常值[...]mmHg	右心房压力（RAP）的正常值1-5mmHg
单选题： 患者，女，46岁，因患骶髋关节结核择期手术，术前常规苯巴比妥钠0.1g，阿托品0.5mg肌注。用硫喷妥钠、琥珀胆碱快速诱导插管，普鲁卡因、哌替啶、氯胺酮全静脉复合维持麻醉，手术历时2小时，术中平稳，术后40分钟苏醒。随即出现大小便失禁，谵妄，躁动不安等症状。 患者术后躁动的原因可能是    A氯胺酮的中枢神经系统作用 B原有精神病发作 C哌替啶的中枢神经系统作用 D硫喷妥钠的中枢神经系统作用脑血管意外 A	单选题： 患者，女，46岁，因患骶髋关节结核择期手术，术前常规苯巴比妥钠0.1g，阿托品0.5mg肌注。用硫喷妥钠、琥珀胆碱快速诱导插管，普鲁卡因、哌替啶、氯胺酮全静脉复合维持麻醉，手术历时2小时，术中平稳，术后40分钟苏醒。随即出现大小便失禁，谵妄，躁动不安等症状。 患者术后躁动的原因可能是   A氯胺酮的中枢神经系统作用 B原有精神病发作 C哌替啶的中枢神经系统作用 D硫喷妥钠的中枢神经系统作用脑血管意外 A      正确答案：                 正确率：100%     解析
为预防和减轻氯胺酮的中枢神经系统作用，麻醉最好复合[...]	为预防和减轻氯胺酮的中枢神经系统作用，麻醉最好复合地西泮或咪达唑仑
单选题： 氯胺酮静脉麻醉的禁忌症是    A基础麻醉 B短小、体表手术或诊断性检查 C甲亢或嗜铬细胞瘤手术失血性休克 E哮喘患者行烧伤手术 C	单选题： 氯胺酮静脉麻醉的禁忌症是   A基础麻醉 B短小、体表手术或诊断性检查 C甲亢或嗜铬细胞瘤手术失血性休克 E哮喘患者行烧伤手术 C      正确答案：                 正确率：100%     氯胺酮能兴奋交感神经，使心率加快，血压升高
控制性降压： 青年人收缩压可降至[...]mmHg，而老年人降至[...]mmHg以上为宜。	控制性降压： 青年人收缩压可降至60-70mmHg，而老年人降至80mmHg以上为宜。
正常人的呼吸频率为每分钟[...]次	正常人的呼吸频率为每分钟12-20次
单选题： 手术结束后麻醉仍深，咳嗽、吞咽反射尚未恢复时，应    A.设法减浅麻醉，待反射恢复后再行拔管 B.待病人完全清醒后，采取侧卧头低位下拔管 C.先置入喉镜，明视下慢慢拔管 D.充分供氧，待喉肌松弛后再拔管 E.气管造口后再拔管 A	单选题： 手术结束后麻醉仍深，咳嗽、吞咽反射尚未恢复时，应   A.设法减浅麻醉，待反射恢复后再行拔管 B.待病人完全清醒后，采取侧卧头低位下拔管 C.先置入喉镜，明视下慢慢拔管 D.充分供氧，待喉肌松弛后再拔管 E.气管造口后再拔管 A      正确答案：                 正确率：100%     解析
单选题： 拔管时发生喉痉挛，应该    A.设法减浅麻醉，待反射恢复后再行拔管 B.待病人完全清醒后，采取侧卧头低位下拔管 C.先置入喉镜，明视下慢慢拔管 D.充分供氧，待喉肌松弛后再拔管 E.气管造口后再拔管 D	单选题： 拔管时发生喉痉挛，应该   A.设法减浅麻醉，待反射恢复后再行拔管 B.待病人完全清醒后，采取侧卧头低位下拔管 C.先置入喉镜，明视下慢慢拔管 D.充分供氧，待喉肌松弛后再拔管 E.气管造口后再拔管 D      正确答案：                 正确率：100%     解析
单选题： 严重脑外伤昏迷，术后仍昏迷者    A.设法减浅麻醉，待反射恢复后再行拔管 B.待病人完全清醒后，采取侧卧头低位下拔管 C.先置入喉镜，明视下慢慢拔管 D.充分供氧，待喉肌松弛后再拔管 E.气管造口后再拔管 E	单选题： 严重脑外伤昏迷，术后仍昏迷者   A.设法减浅麻醉，待反射恢复后再行拔管 B.待病人完全清醒后，采取侧卧头低位下拔管 C.先置入喉镜，明视下慢慢拔管 D.充分供氧，待喉肌松弛后再拔管 E.气管造口后再拔管 E      正确答案：                 正确率：100%     解析
单选题： 饱食后急症手术病人    A.设法减浅麻醉，待反射恢复后再行拔管 B.待病人完全清醒后，采取侧卧头低位下拔管 C.先置入喉镜，明视下慢慢拔管 D.充分供氧，待喉肌松弛后再拔管 E.气管造口后再拔管 B	单选题： 饱食后急症手术病人   A.设法减浅麻醉，待反射恢复后再行拔管 B.待病人完全清醒后，采取侧卧头低位下拔管 C.先置入喉镜，明视下慢慢拔管 D.充分供氧，待喉肌松弛后再拔管 E.气管造口后再拔管 B      正确答案：                 正确率：100%     解析
单选题： 巨大甲状腺癌切除术病人    A.设法减浅麻醉，待反射恢复后再行拔管 B.待病人完全清醒后，采取侧卧头低位下拔管 C.先置入喉镜，明视下慢慢拔管 D.充分供氧，待喉肌松弛后再拔管 E.气管造口后再拔管 C	单选题： 巨大甲状腺癌切除术病人   A.设法减浅麻醉，待反射恢复后再行拔管 B.待病人完全清醒后，采取侧卧头低位下拔管 C.先置入喉镜，明视下慢慢拔管 D.充分供氧，待喉肌松弛后再拔管 E.气管造口后再拔管 C      正确答案：                 正确率：100%     解析
单选题： 为心内直视手术奠定基础的是    A.低温麻醉 B.臂丛神经阻滞 C.硬膜外麻醉技术 D.支气管麻醉技术 E.可卡因的应用 A	单选题： 为心内直视手术奠定基础的是   A.低温麻醉 B.臂丛神经阻滞 C.硬膜外麻醉技术 D.支气管麻醉技术 E.可卡因的应用 A      正确答案：                 正确率：100%     解析
单选题： 使“湿肺”手术更安全的是    A.低温麻醉 B.臂丛神经阻滞 C.硬膜外麻醉技术 D.支气管麻醉技术 E.可卡因的应用 D	单选题： 使“湿肺”手术更安全的是   A.低温麻醉 B.臂丛神经阻滞 C.硬膜外麻醉技术 D.支气管麻醉技术 E.可卡因的应用 D      正确答案：                 正确率：100%     解析：临床上习称手术中脓痰可能进入健侧肺,引起感染播散,呼吸道短时间内可能有大量分泌物或脓痰,可能引起严重通气障碍的肺疾患为“湿肺”
臂丛神经主要由[...]脊神经的前支组成	臂丛神经主要由C5、C6、C7、C8、T1脊神经的前支组成
臂丛神经偶加[...]脊神经的一部分组成	臂丛神经偶加C4及T2脊神经的一部分组成
臂丛的上干由[...]前支构成 中干由[...]前支构成 下干由[...]前支构成	臂丛的上干由C4~C6前支构成 中干由C7前支构成 下干由C8~T2前支构成
单选题： 可引起麻醉手术中肺水肿的原因有    A心力衰竭 B输血输液过量 C大量失血 D呼吸道梗阻 E快速静注大量升压药 ABDE	单选题： 可引起麻醉手术中肺水肿的原因有   A心力衰竭 B输血输液过量 C大量失血 D呼吸道梗阻 E快速静注大量升压药 ABDE      正确答案：                 正确率：100%     解析
上呼吸道三轴线是[...]的连线	上呼吸道三轴线是口腔-咽前壁-喉头-气管上段的连线
胸段硬膜外阻滞不影响[...]（激素）的水平	胸段硬膜外阻滞不影响胰高血糖素（激素）的水平
口对口吹气法在我国最早记录于《[...]》	口对口吹气法在我国最早记录于《肘后备急方》
根据病因及发病机制贫血可分为	红细胞生成减少 红细胞破坏过多 失血
正常人血红蛋白的P50约为[...]mmHg	正常人血红蛋白的P50约为25mmHg
单选题： 安静状态正常成人每分钟需要的氧量，哪项最接近    A200ml B300ml C400ml D500ml E800ml C	单选题： 安静状态正常成人每分钟需要的氧量，哪项最接近   A200ml B300ml C400ml D500ml E800ml C      正确答案：                 正确率：100%     解析
正常生理状态下成人吸空气时PvO2应是[...]mmHg	正常生理状态下成人吸空气时PvO2应是40mmHg  PvO2:静脉血氧分压
最常用于静脉局部麻醉的局麻药是[...]	最常用于静脉局部麻醉的局麻药是利多卡因
单选题： 下列哪项与手术刺激相关    A额肌电 B中潜伏期听觉诱发电位 C食管下段收缩性 D皮肤电阻 E脑电图 C	单选题： 下列哪项与手术刺激相关   A额肌电 B中潜伏期听觉诱发电位 C食管下段收缩性 D皮肤电阻 E脑电图 C      正确答案：                 正确率：100%     解析
代谢性酸中毒最突出的临床表现为[...]	代谢性酸中毒最突出的临床表现为呼吸深而快
单选题： 下列哪一项是甲亢的特殊表现    A休息时心率快 B多食而消瘦 C弥漫性甲状腺肿大 D胫前黏液水肿 E脉压差增大 D	单选题： 下列哪一项是甲亢的特殊表现   A休息时心率快 B多食而消瘦 C弥漫性甲状腺肿大 D胫前黏液水肿 E脉压差增大 D      正确答案：                 正确率：100%     解析
单选题： 关于指间神经的论述，错误的是    A手指由臂丛神经的终末支指间神经支配，可从手指根部阻滞指间神经 B在指间以25G穿刺针刺入手指根部，靠近骨膜缘边抽边注，缓慢注药2~3ml C一般针由手指侧部穿入再逐步进入近手掌部，注药由近掌部到手背部，在穿刺时避免感觉异常，因感觉异常是神经受压表现 D药液中应加用肾上腺素，为防止局麻药吸收过快导致中毒反应 E可用手指手术或单个手指再造术，也可用于臂丛阻滞不全时的辅助阻滞。一般需10～15分钟阻滞完善 D	单选题： 关于指间神经的论述，错误的是   A手指由臂丛神经的终末支指间神经支配，可从手指根部阻滞指间神经 B在指间以25G穿刺针刺入手指根部，靠近骨膜缘边抽边注，缓慢注药2~3ml C一般针由手指侧部穿入再逐步进入近手掌部，注药由近掌部到手背部，在穿刺时避免感觉异常，因感觉异常是神经受压表现 D药液中应加用肾上腺素，为防止局麻药吸收过快导致中毒反应 E可用手指手术或单个手指再造术，也可用于臂丛阻滞不全时的辅助阻滞。一般需10～15分钟阻滞完善 D      正确答案：                 正确率：100%     解析
单选题： 正常成人每昼夜排出的尿量最接近    A500~ 1000ml B1000~2000ml C2000 ~2500ml D2500ml以上 E不多于1000ml B	单选题： 正常成人每昼夜排出的尿量最接近   A500~ 1000ml B1000~2000ml C2000 ~2500ml D2500ml以上 E不多于1000ml B      正确答案：                 正确率：100%     解析
单选题： 食管-气管联合导管的常见并发症不包括    A声带损伤 B食管撕裂 C气胸 D误入食管 E软组织损伤和出血 D	单选题： 食管-气管联合导管的常见并发症不包括   A声带损伤 B食管撕裂 C气胸 D误入食管 E软组织损伤和出血 D      正确答案：                 正确率：100%     解析：
单选题： 有关可乐定的描述，哪项是正确的    Aβ受体激动药 B抑制生长激素的释放 C可椎管内给药，用于术后镇痛 D其镇痛机制与阿片类似 E不易透过血-脑脊液屏障 C	单选题： 有关可乐定的描述，哪项是正确的   Aβ受体激动药 B抑制生长激素的释放 C可椎管内给药，用于术后镇痛 D其镇痛机制与阿片类似 E不易透过血-脑脊液屏障 C      正确答案：                 正确率：100%     解析： 属于a2肾上腺素受体激动剂
单选题： 心功能不全患者行非心脏手术，术中PCWP升高，血浆胶渗压为10mmHg，下列哪项处理措施不妥    A酌情使用强心甙 B硝酸甘油或(和)硝普钠微量泵输入 C使用林格液 D使用胶体液 E使用含胶体的晶体液 C	单选题： 心功能不全患者行非心脏手术，术中PCWP升高，血浆胶渗压为10mmHg，下列哪项处理措施不妥   A酌情使用强心甙 B硝酸甘油或(和)硝普钠微量泵输入 C使用林格液 D使用胶体液 E使用含胶体的晶体液 C      正确答案：                 正确率：100%     解析： 血浆胶体渗透压的正常值：25mmHg PCWP升高提示心功能不全 血浆胶体渗透压降低，而林格液属于晶体液
单选题： PaCO2在40~60mmHg范围内升高时，呼吸运动的改变是    A幅度变深，频率变快 B幅度变浅，频率变快 C幅度变深，频率变慢 D幅度变浅，频率变慢 E幅度变深，频率不变 A	单选题： PaCO2在40~60mmHg范围内升高时，呼吸运动的改变是   A幅度变深，频率变快 B幅度变浅，频率变快 C幅度变深，频率变慢 D幅度变浅，频率变慢 E幅度变深，频率不变 A      正确答案：                 正确率：100%     解析： PaCO2的正常值为35～45mmHg，平均值40mmHg 肺性脑病时，PaC02一般应>70mmHg
单选题： 作为脂肪动用速度指标之一的是    A血浆甘油三酯浓度 B血浆脂肪酸浓度 C血浆乳酸浓度 D血浆极低密度脂蛋白浓度 Eβ脂蛋白水平 B	单选题： 作为脂肪动用速度指标之一的是   A血浆甘油三酯浓度 B血浆脂肪酸浓度 C血浆乳酸浓度 D血浆极低密度脂蛋白浓度 Eβ脂蛋白水平 B      正确答案：                 正确率：100%     解析
[...]g氯化钾相当于20mmolK+	1.5g氯化钾相当于20mmolK+
1.5g氯化钾相当于[...]mmolK+	1.5g氯化钾相当于20mmolK+
单选题： 关于瑞芬太尼，不正确的描述是    A纯μ受体激动剂 B效价是芬太尼的10倍 C为短效阿片类药物 D对呼吸有抑制作用 E可被血浆中非特异性胆碱酯酶迅速水解 B	单选题： 关于瑞芬太尼，不正确的描述是   A纯μ受体激动剂 B效价是芬太尼的10倍 C为短效阿片类药物 D对呼吸有抑制作用 E可被血浆中非特异性胆碱酯酶迅速水解 B      正确答案：                 正确率：100%     解析： 舒芬太尼的镇痛效果是芬太尼的5-10倍； 芬太尼的镇痛效果为吗啡的75-125分钟
单选题： 应用压力传感器时，下述哪项意义不大    A检测时传感器需与右心房高度一致 B校零时传感器需与右心房高度一致 C体位改变时重新校零 D确保压力传导通路无气泡 E体位改变时只需相应调整传感器高度 C	单选题： 应用压力传感器时，下述哪项意义不大   A检测时传感器需与右心房高度一致 B校零时传感器需与右心房高度一致 C体位改变时重新校零 D确保压力传导通路无气泡 E体位改变时只需相应调整传感器高度 C      正确答案：                 正确率：100%     解析：
对功能减退性内分泌疾病应当首选[...]治疗	对功能减退性内分泌疾病应当首选替代治疗
单选题： 在临床上，下列哪项实验室结果与血小板轻度减少最相符    A出血时间延长，凝血时间正常 B出血时间正常，凝血时间延长 C出血时间和凝血时间均延长 D出血时间延长，毛细血管通透性降低 E出血时间和凝血时间均正常，但皮肤、黏膜下经常出现大块紫癜 A	单选题： 在临床上，下列哪项实验室结果与血小板轻度减少最相符   A出血时间延长，凝血时间正常 B出血时间正常，凝血时间延长 C出血时间和凝血时间均延长 D出血时间延长，毛细血管通透性降低 E出血时间和凝血时间均正常，但皮肤、黏膜下经常出现大块紫癜 A      正确答案：                 正确率：100%     解析
单选题： 体内代谢后，可产生有生物活性代谢物的药物是    A苯巴比妥 B地西泮 C甲丙氨酯 D司可巴比妥钠 E水合氯醛 B	单选题： 体内代谢后，可产生有生物活性代谢物的药物是   A苯巴比妥 B地西泮 C甲丙氨酯 D司可巴比妥钠 E水合氯醛 B      正确答案：                 正确率：100%     解析： 主要代谢产物为去甲西泮，还有替马西泮和奥沙西泮，仍有生物活性，故连续应用可蓄积。
单选题： 与血浆胶体渗透压不同的溶液有    A2%NaCl B0.9%NaClC C5%葡萄糖 D10%葡萄糖 E50%葡萄糖 A	单选题： 与血浆胶体渗透压不同的溶液有   A2%NaCl B0.9%NaClC C5%葡萄糖 D10%葡萄糖 E50%葡萄糖 A      正确答案：                 正确率：100%     解析
胸外按压脑血流量最高可达生理情况下的[...]%	胸外按压脑血流量最高可达生理情况下的3%
单选题： 51.患儿，男，7个月，额顶部肿块，诊断为脑脊膜膨出。在全麻气管内插管（导管选择ID4.5带套囊）下行肿块切除术。 拔管后3小时逐渐发生呼吸困难、躁动，心率160次/分。 经面罩吸氧、应用激素、雾化吸入和镇痛治疗1小时后，情况逐渐好转。 术后逐渐发生呼吸困难和躁动最可能的原因是    A咽炎、喉炎 B声带麻痹 C杓状软骨脱臼 D喉水肿或声门下水肿 E气管狭窄 D	单选题： 51.患儿，男，7个月，额顶部肿块，诊断为脑脊膜膨出。在全麻气管内插管（导管选择ID4.5带套囊）下行肿块切除术。 拔管后3小时逐渐发生呼吸困难、躁动，心率160次/分。 经面罩吸氧、应用激素、雾化吸入和镇痛治疗1小时后，情况逐渐好转。 术后逐渐发生呼吸困难和躁动最可能的原因是   A咽炎、喉炎 B声带麻痹 C杓状软骨脱臼 D喉水肿或声门下水肿 E气管狭窄 D      正确答案：                 正确率：100%     解析： 婴幼儿起到最狭窄部位是声门下，气管插管后黏膜水肿易造成气道梗阻
硝普钠控制性降压后引起反跳性血压升高，原因是[...]	硝普钠控制性降压后引起反跳性血压升高，原因是血浆肾素-血管紧张素系统激活
单选题： 有关喉罩的应用，错误的是    A准备型号合适的喉罩 B置入喉罩前应给以表面麻醉或施全麻 C置入喉罩后即行密封罩充气，并检查漏气 D听诊双肺呼吸音，观察胸廓起伏 E气道阻力很大时，应托起下领加压通气 E	单选题： 有关喉罩的应用，错误的是   A准备型号合适的喉罩 B置入喉罩前应给以表面麻醉或施全麻 C置入喉罩后即行密封罩充气，并检查漏气 D听诊双肺呼吸音，观察胸廓起伏 E气道阻力很大时，应托起下领加压通气 E      正确答案：                 正确率：100%     解析： 托下颌法用于舌后坠
单选题： 支气管痉挛时心率加快，应禁用哪种药物    A氨茶碱 B氟哌利多 C氯胺酮 D沙丁胺醇 E艾司洛尔 E	单选题： 支气管痉挛时心率加快，应禁用哪种药物   A氨茶碱 B氟哌利多 C氯胺酮 D沙丁胺醇 E艾司洛尔 E      正确答案：                 正确率：100%     解析： 氨茶碱：对呼吸道平滑肌有直接松弛作用。 氟哌利多：镇静作用 氯胺酮：麻醉剂，支气管平滑肌松弛 沙丁胺醇：短效β2肾上腺素能受体激动剂，用作平喘药，能有效地抑制组胺等致过敏性物质的释放、防止支气管痉挛。
单选题： 患者男，65岁，行体外循环中，什么提示ECMO管路热交换器中血栓形成    A静脉引流下降 B氧合器前压力下降 C氧合器后压力升高 D热交换器失效血 E氧饱和度降低 C	单选题： 患者男，65岁，行体外循环中，什么提示ECMO管路热交换器中血栓形成   A静脉引流下降 B氧合器前压力下降 C氧合器后压力升高 D热交换器失效血 E氧饱和度降低 C      正确答案：                 正确率：100%     解析
单选题： 某唇裂患儿6个月，10kg。择期行唇裂修补术。术前用阿托品0.1mg，进手术室后用2.5%硫喷妥钠8.5ml作深部肌肉注射行基础麻醉，5分钟后入睡。在作口面部消毒时，发现患儿吸气时伴有鸡鸣音，轻度三凹征 最可能的诊断为    A麻醉过深 B喉痉挛 C麻醉过浅 D下颌松弛 E舌后坠 B	单选题： 某唇裂患儿6个月，10kg。择期行唇裂修补术。术前用阿托品0.1mg，进手术室后用2.5%硫喷妥钠8.5ml作深部肌肉注射行基础麻醉，5分钟后入睡。在作口面部消毒时，发现患儿吸气时伴有鸡鸣音，轻度三凹征 最可能的诊断为   A麻醉过深 B喉痉挛 C麻醉过浅 D下颌松弛 E舌后坠 B      正确答案：                 正确率：100%     解析
单选题： 喉痉挛的最佳处理方案为    A追加硫喷妥钠2.5ml B托下颌维持呼吸道通畅 C暂停操作避免刺激，同时给予吸O2 D面罩给O2并正压通气 E立即气管内插管 C	单选题： 喉痉挛的最佳处理方案为   A追加硫喷妥钠2.5ml B托下颌维持呼吸道通畅 C暂停操作避免刺激，同时给予吸O2 D面罩给O2并正压通气 E立即气管内插管 C      正确答案：                 正确率：100%     解析
单选题： 患者，女，40岁，体重75kg，术前诊断:胆囊炎。患者各项术前检查正常，拟在腹腔镜下行胆囊切除术 该患者麻醉中注意的问题正确的是    A人工气腹后不会出现反流误吸 B腹腔镜手术中有可能出现气胸和皮下气肿 C腹腔镜手术不能选择喉罩维持通气 D腹腔镜手术最好选择硬膜外麻醉 E手术过程中不需要过度通气 B	单选题： 患者，女，40岁，体重75kg，术前诊断:胆囊炎。患者各项术前检查正常，拟在腹腔镜下行胆囊切除术 该患者麻醉中注意的问题正确的是   A人工气腹后不会出现反流误吸 B腹腔镜手术中有可能出现气胸和皮下气肿 C腹腔镜手术不能选择喉罩维持通气 D腹腔镜手术最好选择硬膜外麻醉 E手术过程中不需要过度通气 B      正确答案：                 正确率：100%     解析
单选题： 一种钙通道阻滞剂，具有扩张周围血管、冠状动脉及脑血管的作用，降压同时不引起心动过速，这种降压药可能是    A.吸入或静脉麻醉药 B.硝普钠 C.硝酸甘油 D.酚妥拉明 E.尼卡地平 E	单选题： 一种钙通道阻滞剂，具有扩张周围血管、冠状动脉及脑血管的作用，降压同时不引起心动过速，这种降压药可能是   A.吸入或静脉麻醉药 B.硝普钠 C.硝酸甘油 D.酚妥拉明 E.尼卡地平 E      正确答案：                 正确率：100%     解析
单选题： 用于控制性降压的常用药物之一，主要通过扩张外周血管和抑制心肌收缩力来降低血压，可能是    A.吸入或静脉麻醉药 B.硝普钠 C.硝酸甘油 D.酚妥拉明 E.尼卡地平 A	单选题： 用于控制性降压的常用药物之一，主要通过扩张外周血管和抑制心肌收缩力来降低血压，可能是   A.吸入或静脉麻醉药 B.硝普钠 C.硝酸甘油 D.酚妥拉明 E.尼卡地平 A      正确答案：                 正确率：100%     解析
单选题： 用于控制性降压的常用药物之一，主要作用于容量血管，直接抑制血管平滑肌使静脉扩张后，减少回心血量，导致心排量减少和血压降低，可能是    A.吸入或静脉麻醉药 B.硝普钠 C.硝酸甘油 D.酚妥拉明 E.尼卡地平 C	单选题： 用于控制性降压的常用药物之一，主要作用于容量血管，直接抑制血管平滑肌使静脉扩张后，减少回心血量，导致心排量减少和血压降低，可能是   A.吸入或静脉麻醉药 B.硝普钠 C.硝酸甘油 D.酚妥拉明 E.尼卡地平 C      正确答案：                 正确率：100%     解析
肌肉组织丧失血流自身调节能力的最低限度是[...]mmHg	肌肉组织丧失血流自身调节能力的最低限度是20-30mmHg
皮肤、结缔组织丧失血流自身调节能力的最低限度是[...]mmHg	皮肤、结缔组织丧失血流自身调节能力的最低限度是100mmHg
肠道丧失血流自身调节能力的最低限度是[...]mmHg	肠道丧失血流自身调节能力的最低限度是100mmHg
在评估病人的呼吸系统时，有关对其肺功能的评估： 肺活量低于预计值的[...]%，通气储量百分比<[...]%，第1秒用力呼出气量<[...]%，用力肺活量的百分比<[...]%，术后有发生呼吸功能不全的可能	在评估病人的呼吸系统时，有关对其肺功能的评估： 肺活量低于预计值的60%，通气储量百分比<70%，第1秒用力呼出气量<60%，用力肺活量的百分比<50%，术后有发生呼吸功能不全的可能
单选题： 麻醉前准备的首要任务是下列哪一项     A、做好病人体格和精神方面的准备 B、给予病人恰当的麻醉前用药  C、麻醉用具、设备、监测仪器的准备 D、药品（包括急救药品）等的准备 E、麻醉医生自己做的准备 A	单选题： 麻醉前准备的首要任务是下列哪一项    A、做好病人体格和精神方面的准备 B、给予病人恰当的麻醉前用药  C、麻醉用具、设备、监测仪器的准备 D、药品（包括急救药品）等的准备 E、麻醉医生自己做的准备 A      正确答案：                 正确率：100%     解析
单选题： 下列哪项是最常用的麻醉诱导方法     A、静脉快速诱导 B、吸入麻醉诱导 C、保持自主呼吸的诱导 D、清醒插管后再作静脉快速诱导 E、肌注氯氨酮诱导 A	单选题： 下列哪项是最常用的麻醉诱导方法    A、静脉快速诱导 B、吸入麻醉诱导 C、保持自主呼吸的诱导 D、清醒插管后再作静脉快速诱导 E、肌注氯氨酮诱导 A      正确答案：                 正确率：100%     解析
单选题： 下列哪项是椎管内麻醉最严重的并发症     A、头痛 B、硬膜外间隙及蛛网膜下隙感染 C、异常广泛阻滞 D、脊神经根或脊髓损伤 E、穿刺针或导管误入血管 B	单选题： 下列哪项是椎管内麻醉最严重的并发症    A、头痛 B、硬膜外间隙及蛛网膜下隙感染 C、异常广泛阻滞 D、脊神经根或脊髓损伤 E、穿刺针或导管误入血管 B      正确答案：                 正确率：100%     解析
单选题： 缩短非去极化起效时间可以采用预给法，预注给药剂量一般为插管剂量的     A 、1/2 B 、1/3~1/4 C 、1/5~1/10  D、1/15  E、1/20 C	单选题： 缩短非去极化起效时间可以采用预给法，预注给药剂量一般为插管剂量的    A 、1/2 B 、1/3~1/4 C 、1/5~1/10  D、1/15  E、1/20 C      正确答案：                 正确率：100%     解析
单选题： 影响硬膜外麻醉平面最主要的因素是     A、局麻药容积 B、穿刺间隙 C、导管方向 D、注药方式 E、体位 B	单选题： 影响硬膜外麻醉平面最主要的因素是    A、局麻药容积 B、穿刺间隙 C、导管方向 D、注药方式 E、体位 B      正确答案：                 正确率：100%     解析
单选题： 有关腰麻下列叙述哪项错误     A、穿刺部位在脊髓终止以下部位 B、小儿脊髓终止位置较低，新生儿在L3 下缘 C、成人脊髓终止在L1 椎体下缘或L2椎体上缘 D、成人穿刺位置可在L2～L3 以下 E、L3～L4穿刺可避免损伤脊髓和马尾 E	单选题： 有关腰麻下列叙述哪项错误    A、穿刺部位在脊髓终止以下部位 B、小儿脊髓终止位置较低，新生儿在L3 下缘 C、成人脊髓终止在L1 椎体下缘或L2椎体上缘 D、成人穿刺位置可在L2～L3 以下 E、L3～L4穿刺可避免损伤脊髓和马尾 E      正确答案：                 正确率：100%     解析
全麻时引起呼吸道梗阻最常见的原因是[...]	全麻时引起呼吸道梗阻最常见的原因是舌后坠
MPAP是指[...]	MPAP是指肺动脉平均压  mean pulmonary artery pressure
FVC是指[...]	FVC是指用力肺活量  forced vital capacity
简述气管内插管的操作	1.摆放体位：使口、咽、气管置于一条轴线上 2.加压给氧 3.暴露声门 4.插入气管导管
什么是PCA（病人自控镇痛）？	病人可自行按压PCA装置的给药键，按设定的剂量注入镇痛药，从而达到镇痛效果。
含肾上腺素的利多卡因行局部浸润麻醉一次最大的量是[...]mg	含肾上腺素的利多卡因行局部浸润麻醉一次最大的量是500mg
[...]的运动-感觉分离作用最强	罗哌卡因的运动-感觉分离作用最强
椎管内麻醉时出现死亡的主要原因是[...]	椎管内麻醉时出现死亡的主要原因是呼吸抑制
麻醉平面达到脐部是指胸[...]高度	麻醉平面达到脐部是指胸10高度
蛛网膜下腔阻滞时，穿刺针经过的组织依次是	皮肤、皮下组织、棘上韧带、棘间韧带、黄韧带、硬膜外腔、硬膜
